one thousand five hundred and one	fifteen oh one
one thousand five hundred and two	fifteen oh two
one thousand five hundred and three	fifteen oh three
one thousand five hundred and four	fifteen oh four
one thousand five hundred and five	fifteen oh five
one thousand five hundred and six	fifteen oh six
one thousand five hundred and seven	fifteen oh seven
one thousand five hundred and eight	fifteen oh eight
one thousand five hundred and nine	fifteen oh nine
two thousand five hundred	fifteen ten
one thousand five hundred and eleven	fifteen eleven
one thousand five hundred and twelve	fifteen twelve
one thousand five hundred and thirteen	fifteen thirteen
one thousand five hundred and fourteen	fifteen fourteen
one thousand five hundred and fifteen	fifteen fifteen
one thousand five hundred and sixteen	fifteen sixteen
one thousand five hundred and seventeen	fifteen seventeen
one thousand five hundred and eighteen	fifteen eighteen
one thousand five hundred and nineteen	fifteen nineteen
one thousand five hundred and twenty	fifteen twenty
one thousand five hundred and twenty one	fifteen twenty one
one thousand five hundred and twenty two	fifteen twenty two
one thousand five hundred and twenty three	fifteen twenty three
one thousand five hundred and twenty four	fifteen twenty four
one thousand five hundred and twenty five	fifteen twenty five
one thousand five hundred and twenty six	fifteen twenty six
one thousand five hundred and twenty seven	fifteen twenty seven
one thousand five hundred and twenty eight	fifteen twenty eight
one thousand five hundred and twenty nine	fifteen twenty nine
one thousand five hundred and thirty	fifteen thirty
one thousand five hundred and thirty one	fifteen thirty one
one thousand five hundred and thirty two	fifteen thirty two
one thousand five hundred and thirty three	fifteen thirty three
one thousand five hundred and thirty four	fifteen thirty four
one thousand five hundred and thirty five	fifteen thirty five
one thousand five hundred and thirty six	fifteen thirty six
one thousand five hundred and thirty seven	fifteen thirty seven
one thousand five hundred and thirty eight	fifteen thirty eight
one thousand five hundred and thirty nine	fifteen thirty nine
one thousand five hundred and forty	fifteen forty
one thousand five hundred and forty one	fifteen forty one
one thousand five hundred and forty two	fifteen forty two
one thousand five hundred and forty three	fifteen forty three
one thousand five hundred and forty four	fifteen forty four
one thousand five hundred and forty five	fifteen forty five
one thousand five hundred and forty six	fifteen forty six
one thousand five hundred and forty seven	fifteen forty seven
one thousand five hundred and forty eight	fifteen forty eight
one thousand five hundred and forty nine	fifteen forty nine
one thousand five hundred and fifty	fifteen fifty
one thousand five hundred and fifty one	fifteen fifty one
one thousand five hundred and fifty two	fifteen fifty two
one thousand five hundred and fifty three	fifteen fifty three
one thousand five hundred and fifty four	fifteen fifty four
one thousand five hundred and fifty five	fifteen fifty five
one thousand five hundred and fifty six	fifteen fifty six
one thousand five hundred and fifty seven	fifteen fifty seven
one thousand five hundred and fifty eight	fifteen fifty eight
one thousand five hundred and fifty nine	fifteen fifty nine
one thousand five hundred and sixty	fifteen sixty
one thousand five hundred and sixty one	fifteen sixty one
one thousand five hundred and sixty two	fifteen sixty two
one thousand five hundred and sixty three	fifteen sixty three
one thousand five hundred and sixty four	fifteen sixty four
one thousand five hundred and sixty five	fifteen sixty five
one thousand five hundred and sixty six	fifteen sixty six
one thousand five hundred and sixty seven	fifteen sixty seven
one thousand five hundred and sixty eight	fifteen sixty eight
one thousand five hundred and sixty nine	fifteen sixty nine
one thousand five hundred and seventy	fifteen seventy
one thousand five hundred and seventy one	fifteen seventy one
one thousand five hundred and seventy two	fifteen seventy two
one thousand five hundred and seventy three	fifteen seventy three
one thousand five hundred and seventy four	fifteen seventy four
one thousand five hundred and seventy five	fifteen seventy five
one thousand five hundred and seventy six	fifteen seventy six
one thousand five hundred and seventy seven	fifteen seventy seven
one thousand five hundred and seventy eight	fifteen seventy eight
one thousand five hundred and seventy nine	fifteen seventy nine
one thousand five hundred and eighty	fifteen eighty
one thousand five hundred and eighty one	fifteen eighty one
one thousand five hundred and eighty two	fifteen eighty two
one thousand five hundred and eighty three	fifteen eighty three
one thousand five hundred and eighty four	fifteen eighty four
one thousand five hundred and eighty five	fifteen eighty five
one thousand five hundred and eighty six	fifteen eighty six
one thousand five hundred and eighty seven	fifteen eighty seven
one thousand five hundred and eighty eight	fifteen eighty eight
one thousand five hundred and eighty nine	fifteen eighty nine
one thousand five hundred and ninety	fifteen ninety
one thousand five hundred and ninety one	fifteen ninety one
one thousand five hundred and ninety two	fifteen ninety two
one thousand five hundred and ninety three	fifteen ninety three
one thousand five hundred and ninety four	fifteen ninety four
one thousand five hundred and ninety five	fifteen ninety five
one thousand five hundred and ninety six	fifteen ninety six
one thousand five hundred and ninety seven	fifteen ninety seven
one thousand five hundred and ninety eight	fifteen ninety eight
one thousand five hundred and ninety nine	fifteen ninety nine
one thousand six hundred	sixteen hundred
one thousand six hundred and one	sixteen oh one
one thousand six hundred and two	sixteen oh two
one thousand six hundred and three	sixteen oh three
one thousand six hundred and four	sixteen oh four
one thousand six hundred and five	sixteen oh five
one thousand six hundred and six	sixteen oh six
one thousand six hundred and seven	sixteen oh seven
one thousand six hundred and eight	sixteen oh eight
one thousand six hundred and nine	sixteen oh nine
two thousand six hundred	sixteen ten
one thousand six hundred and eleven	sixteen eleven
one thousand six hundred and twelve	sixteen twelve
one thousand six hundred and thirteen	sixteen thirteen
one thousand six hundred and fourteen	sixteen fourteen
one thousand six hundred and fifteen	sixteen fifteen
one thousand six hundred and sixteen	sixteen sixteen
one thousand six hundred and seventeen	sixteen seventeen
one thousand six hundred and eighteen	sixteen eighteen
one thousand six hundred and nineteen	sixteen nineteen
one thousand six hundred and twenty	sixteen twenty
one thousand six hundred and twenty one	sixteen twenty one
one thousand six hundred and twenty two	sixteen twenty two
one thousand six hundred and twenty three	sixteen twenty three
one thousand six hundred and twenty four	sixteen twenty four
one thousand six hundred and twenty five	sixteen twenty five
one thousand six hundred and twenty six	sixteen twenty six
one thousand six hundred and twenty seven	sixteen twenty seven
one thousand six hundred and twenty eight	sixteen twenty eight
one thousand six hundred and twenty nine	sixteen twenty nine
one thousand six hundred and thirty	sixteen thirty
one thousand six hundred and thirty one	sixteen thirty one
one thousand six hundred and thirty two	sixteen thirty two
one thousand six hundred and thirty three	sixteen thirty three
one thousand six hundred and thirty four	sixteen thirty four
one thousand six hundred and thirty five	sixteen thirty five
one thousand six hundred and thirty six	sixteen thirty six
one thousand six hundred and thirty seven	sixteen thirty seven
one thousand six hundred and thirty eight	sixteen thirty eight
one thousand six hundred and thirty nine	sixteen thirty nine
one thousand six hundred and forty	sixteen forty
one thousand six hundred and forty one	sixteen forty one
one thousand six hundred and forty two	sixteen forty two
one thousand six hundred and forty three	sixteen forty three
one thousand six hundred and forty four	sixteen forty four
one thousand six hundred and forty five	sixteen forty five
one thousand six hundred and forty six	sixteen forty six
one thousand six hundred and forty seven	sixteen forty seven
one thousand six hundred and forty eight	sixteen forty eight
one thousand six hundred and forty nine	sixteen forty nine
one thousand six hundred and fifty	sixteen fifty
one thousand six hundred and fifty one	sixteen fifty one
one thousand six hundred and fifty two	sixteen fifty two
one thousand six hundred and fifty three	sixteen fifty three
one thousand six hundred and fifty four	sixteen fifty four
one thousand six hundred and fifty five	sixteen fifty five
one thousand six hundred and fifty six	sixteen fifty six
one thousand six hundred and fifty seven	sixteen fifty seven
one thousand six hundred and fifty eight	sixteen fifty eight
one thousand six hundred and fifty nine	sixteen fifty nine
one thousand six hundred and sixty	sixteen sixty
one thousand six hundred and sixty one	sixteen sixty one
one thousand six hundred and sixty two	sixteen sixty two
one thousand six hundred and sixty three	sixteen sixty three
one thousand six hundred and sixty four	sixteen sixty four
one thousand six hundred and sixty five	sixteen sixty five
one thousand six hundred and sixty six	sixteen sixty six
one thousand six hundred and sixty seven	sixteen sixty seven
one thousand six hundred and sixty eight	sixteen sixty eight
one thousand six hundred and sixty nine	sixteen sixty nine
one thousand six hundred and seventy	sixteen seventy
one thousand six hundred and seventy one	sixteen seventy one
one thousand six hundred and seventy two	sixteen seventy two
one thousand six hundred and seventy three	sixteen seventy three
one thousand six hundred and seventy four	sixteen seventy four
one thousand six hundred and seventy five	sixteen seventy five
one thousand six hundred and seventy six	sixteen seventy six
one thousand six hundred and seventy seven	sixteen seventy seven
one thousand six hundred and seventy eight	sixteen seventy eight
one thousand six hundred and seventy nine	sixteen seventy nine
one thousand six hundred and eighty	sixteen eighty
one thousand six hundred and eighty one	sixteen eighty one
one thousand six hundred and eighty two	sixteen eighty two
one thousand six hundred and eighty three	sixteen eighty three
one thousand six hundred and eighty four	sixteen eighty four
one thousand six hundred and eighty five	sixteen eighty five
one thousand six hundred and eighty six	sixteen eighty six
one thousand six hundred and eighty seven	sixteen eighty seven
one thousand six hundred and eighty eight	sixteen eighty eight
one thousand six hundred and eighty nine	sixteen eighty nine
one thousand six hundred and ninety	sixteen ninety
one thousand six hundred and ninety one	sixteen ninety one
one thousand six hundred and ninety two	sixteen ninety two
one thousand six hundred and ninety three	sixteen ninety three
one thousand six hundred and ninety four	sixteen ninety four
one thousand six hundred and ninety five	sixteen ninety five
one thousand six hundred and ninety six	sixteen ninety six
one thousand six hundred and ninety seven	sixteen ninety seven
one thousand six hundred and ninety eight	sixteen ninety eight
one thousand six hundred and ninety nine	sixteen ninety nine
one thousand seven hundred	seventeen hundred
one thousand seven hundred and one	seventeen oh one
one thousand seven hundred and two	seventeen oh two
one thousand seven hundred and three	seventeen oh three
one thousand seven hundred and four	seventeen oh four
one thousand seven hundred and five	seventeen oh five
one thousand seven hundred and six	seventeen oh six
one thousand seven hundred and seven	seventeen oh seven
one thousand seven hundred and eight	seventeen oh eight
one thousand seven hundred and nine	seventeen oh nine
two thousand seven hundred	seventeen ten
one thousand seven hundred and eleven	seventeen eleven
one thousand seven hundred and twelve	seventeen twelve
one thousand seven hundred and thirteen	seventeen thirteen
one thousand seven hundred and fourteen	seventeen fourteen
one thousand seven hundred and fifteen	seventeen fifteen
one thousand seven hundred and sixteen	seventeen sixteen
one thousand seven hundred and seventeen	seventeen seventeen
one thousand seven hundred and eighteen	seventeen eighteen
one thousand seven hundred and nineteen	seventeen nineteen
one thousand seven hundred and twenty	seventeen twenty
one thousand seven hundred and twenty one	seventeen twenty one
one thousand seven hundred and twenty two	seventeen twenty two
one thousand seven hundred and twenty three	seventeen twenty three
one thousand seven hundred and twenty four	seventeen twenty four
one thousand seven hundred and twenty five	seventeen twenty five
one thousand seven hundred and twenty six	seventeen twenty six
one thousand seven hundred and twenty seven	seventeen twenty seven
one thousand seven hundred and twenty eight	seventeen twenty eight
one thousand seven hundred and twenty nine	seventeen twenty nine
one thousand seven hundred and thirty	seventeen thirty
one thousand seven hundred and thirty one	seventeen thirty one
one thousand seven hundred and thirty two	seventeen thirty two
one thousand seven hundred and thirty three	seventeen thirty three
one thousand seven hundred and thirty four	seventeen thirty four
one thousand seven hundred and thirty five	seventeen thirty five
one thousand seven hundred and thirty six	seventeen thirty six
one thousand seven hundred and thirty seven	seventeen thirty seven
one thousand seven hundred and thirty eight	seventeen thirty eight
one thousand seven hundred and thirty nine	seventeen thirty nine
one thousand seven hundred and forty	seventeen forty
one thousand seven hundred and forty one	seventeen forty one
one thousand seven hundred and forty two	seventeen forty two
one thousand seven hundred and forty three	seventeen forty three
one thousand seven hundred and forty four	seventeen forty four
one thousand seven hundred and forty five	seventeen forty five
one thousand seven hundred and forty six	seventeen forty six
one thousand seven hundred and forty seven	seventeen forty seven
one thousand seven hundred and forty eight	seventeen forty eight
one thousand seven hundred and forty nine	seventeen forty nine
one thousand seven hundred and fifty	seventeen fifty
one thousand seven hundred and fifty one	seventeen fifty one
one thousand seven hundred and fifty two	seventeen fifty two
one thousand seven hundred and fifty three	seventeen fifty three
one thousand seven hundred and fifty four	seventeen fifty four
one thousand seven hundred and fifty five	seventeen fifty five
one thousand seven hundred and fifty six	seventeen fifty six
one thousand seven hundred and fifty seven	seventeen fifty seven
one thousand seven hundred and fifty eight	seventeen fifty eight
one thousand seven hundred and fifty nine	seventeen fifty nine
one thousand seven hundred and sixty	seventeen sixty
one thousand seven hundred and sixty one	seventeen sixty one
one thousand seven hundred and sixty two	seventeen sixty two
one thousand seven hundred and sixty three	seventeen sixty three
one thousand seven hundred and sixty four	seventeen sixty four
one thousand seven hundred and sixty five	seventeen sixty five
one thousand seven hundred and sixty six	seventeen sixty six
one thousand seven hundred and sixty seven	seventeen sixty seven
one thousand seven hundred and sixty eight	seventeen sixty eight
one thousand seven hundred and sixty nine	seventeen sixty nine
one thousand seven hundred and seventy	seventeen seventy
one thousand seven hundred and seventy one	seventeen seventy one
one thousand seven hundred and seventy two	seventeen seventy two
one thousand seven hundred and seventy three	seventeen seventy three
one thousand seven hundred and seventy four	seventeen seventy four
one thousand seven hundred and seventy five	seventeen seventy five
one thousand seven hundred and seventy six	seventeen seventy six
one thousand seven hundred and seventy seven	seventeen seventy seven
one thousand seven hundred and seventy eight	seventeen seventy eight
one thousand seven hundred and seventy nine	seventeen seventy nine
one thousand seven hundred and eighty	seventeen eighty
one thousand seven hundred and eighty one	seventeen eighty one
one thousand seven hundred and eighty two	seventeen eighty two
one thousand seven hundred and eighty three	seventeen eighty three
one thousand seven hundred and eighty four	seventeen eighty four
one thousand seven hundred and eighty five	seventeen eighty five
one thousand seven hundred and eighty six	seventeen eighty six
one thousand seven hundred and eighty seven	seventeen eighty seven
one thousand seven hundred and eighty eight	seventeen eighty eight
one thousand seven hundred and eighty nine	seventeen eighty nine
one thousand seven hundred and ninety	seventeen ninety
one thousand seven hundred and ninety one	seventeen ninety one
one thousand seven hundred and ninety two	seventeen ninety two
one thousand seven hundred and ninety three	seventeen ninety three
one thousand seven hundred and ninety four	seventeen ninety four
one thousand seven hundred and ninety five	seventeen ninety five
one thousand seven hundred and ninety six	seventeen ninety six
one thousand seven hundred and ninety seven	seventeen ninety seven
one thousand seven hundred and ninety eight	seventeen ninety eight
one thousand seven hundred and ninety nine	seventeen ninety nine
one thousand eight hundred	eighteen hundred
one thousand eight hundred and one	eighteen oh one
one thousand eight hundred and two	eighteen oh two
one thousand eight hundred and three	eighteen oh three
one thousand eight hundred and four	eighteen oh four
one thousand eight hundred and five	eighteen oh five
one thousand eight hundred and six	eighteen oh six
one thousand eight hundred and seven	eighteen oh seven
one thousand eight hundred and eight	eighteen oh eight
one thousand eight hundred and nine	eighteen oh nine
two thousand eight hundred	eighteen ten
one thousand eight hundred and eleven	eighteen eleven
one thousand eight hundred and twelve	eighteen twelve
one thousand eight hundred and thirteen	eighteen thirteen
one thousand eight hundred and fourteen	eighteen fourteen
one thousand eight hundred and fifteen	eighteen fifteen
one thousand eight hundred and sixteen	eighteen sixteen
one thousand eight hundred and seventeen	eighteen seventeen
one thousand eight hundred and eighteen	eighteen eighteen
one thousand eight hundred and nineteen	eighteen nineteen
one thousand eight hundred and twenty	eighteen twenty
one thousand eight hundred and twenty one	eighteen twenty one
one thousand eight hundred and twenty two	eighteen twenty two
one thousand eight hundred and twenty three	eighteen twenty three
one thousand eight hundred and twenty four	eighteen twenty four
one thousand eight hundred and twenty five	eighteen twenty five
one thousand eight hundred and twenty six	eighteen twenty six
one thousand eight hundred and twenty seven	eighteen twenty seven
one thousand eight hundred and twenty eight	eighteen twenty eight
one thousand eight hundred and twenty nine	eighteen twenty nine
one thousand eight hundred and thirty	eighteen thirty
one thousand eight hundred and thirty one	eighteen thirty one
one thousand eight hundred and thirty two	eighteen thirty two
one thousand eight hundred and thirty three	eighteen thirty three
one thousand eight hundred and thirty four	eighteen thirty four
one thousand eight hundred and thirty five	eighteen thirty five
one thousand eight hundred and thirty six	eighteen thirty six
one thousand eight hundred and thirty seven	eighteen thirty seven
one thousand eight hundred and thirty eight	eighteen thirty eight
one thousand eight hundred and thirty nine	eighteen thirty nine
one thousand eight hundred and forty	eighteen forty
one thousand eight hundred and forty one	eighteen forty one
one thousand eight hundred and forty two	eighteen forty two
one thousand eight hundred and forty three	eighteen forty three
one thousand eight hundred and forty four	eighteen forty four
one thousand eight hundred and forty five	eighteen forty five
one thousand eight hundred and forty six	eighteen forty six
one thousand eight hundred and forty seven	eighteen forty seven
one thousand eight hundred and forty eight	eighteen forty eight
one thousand eight hundred and forty nine	eighteen forty nine
one thousand eight hundred and fifty	eighteen fifty
one thousand eight hundred and fifty one	eighteen fifty one
one thousand eight hundred and fifty two	eighteen fifty two
one thousand eight hundred and fifty three	eighteen fifty three
one thousand eight hundred and fifty four	eighteen fifty four
one thousand eight hundred and fifty five	eighteen fifty five
one thousand eight hundred and fifty six	eighteen fifty six
one thousand eight hundred and fifty seven	eighteen fifty seven
one thousand eight hundred and fifty eight	eighteen fifty eight
one thousand eight hundred and fifty nine	eighteen fifty nine
one thousand eight hundred and sixty	eighteen sixty
one thousand eight hundred and sixty one	eighteen sixty one
one thousand eight hundred and sixty two	eighteen sixty two
one thousand eight hundred and sixty three	eighteen sixty three
one thousand eight hundred and sixty four	eighteen sixty four
one thousand eight hundred and sixty five	eighteen sixty five
one thousand eight hundred and sixty six	eighteen sixty six
one thousand eight hundred and sixty seven	eighteen sixty seven
one thousand eight hundred and sixty eight	eighteen sixty eight
one thousand eight hundred and sixty nine	eighteen sixty nine
one thousand eight hundred and seventy	eighteen seventy
one thousand eight hundred and seventy one	eighteen seventy one
one thousand eight hundred and seventy two	eighteen seventy two
one thousand eight hundred and seventy three	eighteen seventy three
one thousand eight hundred and seventy four	eighteen seventy four
one thousand eight hundred and seventy five	eighteen seventy five
one thousand eight hundred and seventy six	eighteen seventy six
one thousand eight hundred and seventy seven	eighteen seventy seven
one thousand eight hundred and seventy eight	eighteen seventy eight
one thousand eight hundred and seventy nine	eighteen seventy nine
one thousand eight hundred and eighty	eighteen eighty
one thousand eight hundred and eighty one	eighteen eighty one
one thousand eight hundred and eighty two	eighteen eighty two
one thousand eight hundred and eighty three	eighteen eighty three
one thousand eight hundred and eighty four	eighteen eighty four
one thousand eight hundred and eighty five	eighteen eighty five
one thousand eight hundred and eighty six	eighteen eighty six
one thousand eight hundred and eighty seven	eighteen eighty seven
one thousand eight hundred and eighty eight	eighteen eighty eight
one thousand eight hundred and eighty nine	eighteen eighty nine
one thousand eight hundred and ninety	eighteen ninety
one thousand eight hundred and ninety one	eighteen ninety one
one thousand eight hundred and ninety two	eighteen ninety two
one thousand eight hundred and ninety three	eighteen ninety three
one thousand eight hundred and ninety four	eighteen ninety four
one thousand eight hundred and ninety five	eighteen ninety five
one thousand eight hundred and ninety six	eighteen ninety six
one thousand eight hundred and ninety seven	eighteen ninety seven
one thousand eight hundred and ninety eight	eighteen ninety eight
one thousand eight hundred and ninety nine	eighteen ninety nine
one thousand nine hundred	nineteen hundred
one thousand nine hundred and one	nineteen oh one
one thousand nine hundred and two	nineteen oh two
one thousand nine hundred and three	nineteen oh three
one thousand nine hundred and four	nineteen oh four
one thousand nine hundred and five	nineteen oh five
one thousand nine hundred and six	nineteen oh six
one thousand nine hundred and seven	nineteen oh seven
one thousand nine hundred and eight	nineteen oh eight
one thousand nine hundred and nine	nineteen oh nine
two thousand nine hundred	nineteen ten
one thousand nine hundred and eleven	nineteen eleven
one thousand nine hundred and twelve	nineteen twelve
one thousand nine hundred and thirteen	nineteen thirteen
one thousand nine hundred and fourteen	nineteen fourteen
one thousand nine hundred and fifteen	nineteen fifteen
one thousand nine hundred and sixteen	nineteen sixteen
one thousand nine hundred and seventeen	nineteen seventeen
one thousand nine hundred and eighteen	nineteen eighteen
one thousand nine hundred and nineteen	nineteen nineteen
one thousand nine hundred and twenty	nineteen twenty
one thousand nine hundred and twenty one	nineteen twenty one
one thousand nine hundred and twenty two	nineteen twenty two
one thousand nine hundred and twenty three	nineteen twenty three
one thousand nine hundred and twenty four	nineteen twenty four
one thousand nine hundred and twenty five	nineteen twenty five
one thousand nine hundred and twenty six	nineteen twenty six
one thousand nine hundred and twenty seven	nineteen twenty seven
one thousand nine hundred and twenty eight	nineteen twenty eight
one thousand nine hundred and twenty nine	nineteen twenty nine
one thousand nine hundred and thirty	nineteen thirty
one thousand nine hundred and thirty one	nineteen thirty one
one thousand nine hundred and thirty two	nineteen thirty two
one thousand nine hundred and thirty three	nineteen thirty three
one thousand nine hundred and thirty four	nineteen thirty four
one thousand nine hundred and thirty five	nineteen thirty five
one thousand nine hundred and thirty six	nineteen thirty six
one thousand nine hundred and thirty seven	nineteen thirty seven
one thousand nine hundred and thirty eight	nineteen thirty eight
one thousand nine hundred and thirty nine	nineteen thirty nine
one thousand nine hundred and forty	nineteen forty
one thousand nine hundred and forty one	nineteen forty one
one thousand nine hundred and forty two	nineteen forty two
one thousand nine hundred and forty three	nineteen forty three
one thousand nine hundred and forty four	nineteen forty four
one thousand nine hundred and forty five	nineteen forty five
one thousand nine hundred and forty six	nineteen forty six
one thousand nine hundred and forty seven	nineteen forty seven
one thousand nine hundred and forty eight	nineteen forty eight
one thousand nine hundred and forty nine	nineteen forty nine
one thousand nine hundred and fifty	nineteen fifty
one thousand nine hundred and fifty one	nineteen fifty one
one thousand nine hundred and fifty two	nineteen fifty two
one thousand nine hundred and fifty three	nineteen fifty three
one thousand nine hundred and fifty four	nineteen fifty four
one thousand nine hundred and fifty five	nineteen fifty five
one thousand nine hundred and fifty six	nineteen fifty six
one thousand nine hundred and fifty seven	nineteen fifty seven
one thousand nine hundred and fifty eight	nineteen fifty eight
one thousand nine hundred and fifty nine	nineteen fifty nine
one thousand nine hundred and sixty	nineteen sixty
one thousand nine hundred and sixty one	nineteen sixty one
one thousand nine hundred and sixty two	nineteen sixty two
one thousand nine hundred and sixty three	nineteen sixty three
one thousand nine hundred and sixty four	nineteen sixty four
one thousand nine hundred and sixty five	nineteen sixty five
one thousand nine hundred and sixty six	nineteen sixty six
one thousand nine hundred and sixty seven	nineteen sixty seven
one thousand nine hundred and sixty eight	nineteen sixty eight
one thousand nine hundred and sixty nine	nineteen sixty nine
one thousand nine hundred and seventy	nineteen seventy
one thousand nine hundred and seventy one	nineteen seventy one
one thousand nine hundred and seventy two	nineteen seventy two
one thousand nine hundred and seventy three	nineteen seventy three
one thousand nine hundred and seventy four	nineteen seventy four
one thousand nine hundred and seventy five	nineteen seventy five
one thousand nine hundred and seventy six	nineteen seventy six
one thousand nine hundred and seventy seven	nineteen seventy seven
one thousand nine hundred and seventy eight	nineteen seventy eight
one thousand nine hundred and seventy nine	nineteen seventy nine
one thousand nine hundred and eighty	nineteen eighty
one thousand nine hundred and eighty one	nineteen eighty one
one thousand nine hundred and eighty two	nineteen eighty two
one thousand nine hundred and eighty three	nineteen eighty three
one thousand nine hundred and eighty four	nineteen eighty four
one thousand nine hundred and eighty five	nineteen eighty five
one thousand nine hundred and eighty six	nineteen eighty six
one thousand nine hundred and eighty seven	nineteen eighty seven
one thousand nine hundred and eighty eight	nineteen eighty eight
one thousand nine hundred and eighty nine	nineteen eighty nine
one thousand nine hundred and ninety	nineteen ninety
one thousand nine hundred and ninety one	nineteen ninety one
one thousand nine hundred and ninety two	nineteen ninety two
one thousand nine hundred and ninety three	nineteen ninety three
one thousand nine hundred and ninety four	nineteen ninety four
one thousand nine hundred and ninety five	nineteen ninety five
one thousand nine hundred and ninety six	nineteen ninety six
one thousand nine hundred and ninety seven	nineteen ninety seven
one thousand nine hundred and ninety eight	nineteen ninety eight
one thousand nine hundred and ninety nine	nineteen ninety nine
two thousand and one	twenty oh one
two thousand and two	twenty oh two
two thousand and three	twenty oh three
two thousand and four	twenty oh four
two thousand and five	twenty oh five
two thousand and six	twenty oh six
two thousand and seven	twenty oh seven
two thousand and eight	twenty oh eight
two thousand and nine	twenty oh nine
two thousand and ten	twenty ten
two thousand and eleven	twenty eleven
two thousand and twelve	twenty twelve
two thousand and thirteen	twenty thirteen
two thousand and fourteen	twenty fourteen
two thousand and fifteen	twenty fifteen
two thousand and sixteen	twenty sixteen
two thousand and seventeen	twenty seventeen
two thousand and eighteen	twenty eighteen
two thousand and nineteen	twenty nineteen
two thousand and twenty	twenty twenty
two thousand and twenty one	twenty twenty one
two thousand and twenty two	twenty twenty two
two thousand and twenty three	twenty twenty three
two thousand and twenty four	twenty twenty four
two thousand and twenty five	twenty twenty five
two thousand and twenty six	twenty twenty six
two thousand and twenty seven	twenty twenty seven
two thousand and twenty eight	twenty twenty eight
two thousand and twenty nine	twenty twenty nine
two thousand and thirty	twenty thirty
two thousand and thirty one	twenty thirty one
two thousand and thirty two	twenty thirty two
two thousand and thirty three	twenty thirty three
two thousand and thirty four	twenty thirty four
two thousand and thirty five	twenty thirty five
two thousand and thirty six	twenty thirty six
two thousand and thirty seven	twenty thirty seven
two thousand and thirty eight	twenty thirty eight
two thousand and thirty nine	twenty thirty nine
two thousand and forty	twenty forty
two thousand and forty one	twenty forty one
two thousand and forty two	twenty forty two
two thousand and forty three	twenty forty three
two thousand and forty four	twenty forty four
two thousand and forty five	twenty forty five
two thousand and forty six	twenty forty six
two thousand and forty seven	twenty forty seven
two thousand and forty eight	twenty forty eight
two thousand and forty nine	twenty forty nine
two thousand and fifty	twenty fifty
two thousand and fifty one	twenty fifty one
two thousand and fifty two	twenty fifty two
two thousand and fifty three	twenty fifty three
two thousand and fifty four	twenty fifty four
two thousand and fifty five	twenty fifty five
two thousand and fifty six	twenty fifty six
two thousand and fifty seven	twenty fifty seven
two thousand and fifty eight	twenty fifty eight
two thousand and fifty nine	twenty fifty nine
two thousand and sixty	twenty sixty
two thousand and sixty one	twenty sixty one
two thousand and sixty two	twenty sixty two
two thousand and sixty three	twenty sixty three
two thousand and sixty four	twenty sixty four
two thousand and sixty five	twenty sixty five
two thousand and sixty six	twenty sixty six
two thousand and sixty seven	twenty sixty seven
two thousand and sixty eight	twenty sixty eight
two thousand and sixty nine	twenty sixty nine
two thousand and seventy	twenty seventy
two thousand and seventy one	twenty seventy one
two thousand and seventy two	twenty seventy two
two thousand and seventy three	twenty seventy three
two thousand and seventy four	twenty seventy four
two thousand and seventy five	twenty seventy five
two thousand and seventy six	twenty seventy six
two thousand and seventy seven	twenty seventy seven
two thousand and seventy eight	twenty seventy eight
two thousand and seventy nine	twenty seventy nine
two thousand and eighty	twenty eighty
two thousand and eighty one	twenty eighty one
two thousand and eighty two	twenty eighty two
two thousand and eighty three	twenty eighty three
two thousand and eighty four	twenty eighty four
two thousand and eighty five	twenty eighty five
two thousand and eighty six	twenty eighty six
two thousand and eighty seven	twenty eighty seven
two thousand and eighty eight	twenty eighty eight
two thousand and eighty nine	twenty eighty nine
two thousand and ninety	twenty ninety
two thousand and ninety one	twenty ninety one
two thousand and ninety two	twenty ninety two
two thousand and ninety three	twenty ninety three
two thousand and ninety four	twenty ninety four
two thousand and ninety five	twenty ninety five
two thousand and ninety six	twenty ninety six
two thousand and ninety seven	twenty ninety seven
two thousand and ninety eight	twenty ninety eight
two thousand and ninety nine	twenty ninety nine
two thousand one hundred	twenty one hundred
two thousand one hundred and one	twenty one oh one
two thousand one hundred and two	twenty one oh two
two thousand one hundred and three	twenty one oh three
two thousand one hundred and four	twenty one oh four
two thousand one hundred and five	twenty one oh five
two thousand one hundred and six	twenty one oh six
two thousand one hundred and seven	twenty one oh seven
two thousand one hundred and eight	twenty one oh eight
two thousand one hundred and nine	twenty one oh nine
two thousand one hundred and ten	twenty one ten
two thousand one hundred and eleven	twenty one eleven
two thousand one hundred and twelve	twenty one twelve
two thousand one hundred and thirteen	twenty one thirteen
two thousand one hundred and fourteen	twenty one fourteen
two thousand one hundred and fifteen	twenty one fifteen
two thousand one hundred and sixteen	twenty one sixteen
two thousand one hundred and seventeen	twenty one seventeen
two thousand one hundred and eighteen	twenty one eighteen
two thousand one hundred and nineteen	twenty one nineteen
two thousand one hundred and twenty	twenty one twenty
two thousand one hundred and twenty one	twenty one twenty one
two thousand one hundred and twenty two	twenty one twenty two
two thousand one hundred and twenty three	twenty one twenty three
two thousand one hundred and twenty four	twenty one twenty four
two thousand one hundred and twenty five	twenty one twenty five
two thousand one hundred and twenty six	twenty one twenty six
two thousand one hundred and twenty seven	twenty one twenty seven
two thousand one hundred and twenty eight	twenty one twenty eight
two thousand one hundred and twenty nine	twenty one twenty nine
two thousand one hundred and thirty	twenty one thirty
two thousand one hundred and thirty one	twenty one thirty one
two thousand one hundred and thirty two	twenty one thirty two
two thousand one hundred and thirty three	twenty one thirty three
two thousand one hundred and thirty four	twenty one thirty four
two thousand one hundred and thirty five	twenty one thirty five
two thousand one hundred and thirty six	twenty one thirty six
two thousand one hundred and thirty seven	twenty one thirty seven
two thousand one hundred and thirty eight	twenty one thirty eight
two thousand one hundred and thirty nine	twenty one thirty nine
two thousand one hundred and forty	twenty one forty
two thousand one hundred and forty one	twenty one forty one
two thousand one hundred and forty two	twenty one forty two
two thousand one hundred and forty three	twenty one forty three
two thousand one hundred and forty four	twenty one forty four
two thousand one hundred and forty five	twenty one forty five
two thousand one hundred and forty six	twenty one forty six
two thousand one hundred and forty seven	twenty one forty seven
two thousand one hundred and forty eight	twenty one forty eight
two thousand one hundred and forty nine	twenty one forty nine
two thousand one hundred and fifty	twenty one fifty
two thousand one hundred and fifty one	twenty one fifty one
two thousand one hundred and fifty two	twenty one fifty two
two thousand one hundred and fifty three	twenty one fifty three
two thousand one hundred and fifty four	twenty one fifty four
two thousand one hundred and fifty five	twenty one fifty five
two thousand one hundred and fifty six	twenty one fifty six
two thousand one hundred and fifty seven	twenty one fifty seven
two thousand one hundred and fifty eight	twenty one fifty eight
two thousand one hundred and fifty nine	twenty one fifty nine
two thousand one hundred and sixty	twenty one sixty
two thousand one hundred and sixty one	twenty one sixty one
two thousand one hundred and sixty two	twenty one sixty two
two thousand one hundred and sixty three	twenty one sixty three
two thousand one hundred and sixty four	twenty one sixty four
two thousand one hundred and sixty five	twenty one sixty five
two thousand one hundred and sixty six	twenty one sixty six
two thousand one hundred and sixty seven	twenty one sixty seven
two thousand one hundred and sixty eight	twenty one sixty eight
two thousand one hundred and sixty nine	twenty one sixty nine
two thousand one hundred and seventy	twenty one seventy
two thousand one hundred and seventy one	twenty one seventy one
two thousand one hundred and seventy two	twenty one seventy two
two thousand one hundred and seventy three	twenty one seventy three
two thousand one hundred and seventy four	twenty one seventy four
two thousand one hundred and seventy five	twenty one seventy five
two thousand one hundred and seventy six	twenty one seventy six
two thousand one hundred and seventy seven	twenty one seventy seven
two thousand one hundred and seventy eight	twenty one seventy eight
two thousand one hundred and seventy nine	twenty one seventy nine
two thousand one hundred and eighty	twenty one eighty
two thousand one hundred and eighty one	twenty one eighty one
two thousand one hundred and eighty two	twenty one eighty two
two thousand one hundred and eighty three	twenty one eighty three
two thousand one hundred and eighty four	twenty one eighty four
two thousand one hundred and eighty five	twenty one eighty five
two thousand one hundred and eighty six	twenty one eighty six
two thousand one hundred and eighty seven	twenty one eighty seven
two thousand one hundred and eighty eight	twenty one eighty eight
two thousand one hundred and eighty nine	twenty one eighty nine
two thousand one hundred and ninety	twenty one ninety
two thousand one hundred and ninety one	twenty one ninety one
two thousand one hundred and ninety two	twenty one ninety two
two thousand one hundred and ninety three	twenty one ninety three
two thousand one hundred and ninety four	twenty one ninety four
two thousand one hundred and ninety five	twenty one ninety five
two thousand one hundred and ninety six	twenty one ninety six
two thousand one hundred and ninety seven	twenty one ninety seven
two thousand one hundred and ninety eight	twenty one ninety eight
two thousand one hundred and ninety nine	twenty one ninety nine
two thousand two hundred	twenty two hundred
two thousand two hundred and one	twenty two oh one
two thousand two hundred and two	twenty two oh two
two thousand two hundred and three	twenty two oh three
two thousand two hundred and four	twenty two oh four
two thousand two hundred and five	twenty two oh five
two thousand two hundred and six	twenty two oh six
two thousand two hundred and seven	twenty two oh seven
two thousand two hundred and eight	twenty two oh eight
two thousand two hundred and nine	twenty two oh nine
two thousand two hundred and ten	twenty two ten
two thousand two hundred and eleven	twenty two eleven
two thousand two hundred and twelve	twenty two twelve
two thousand two hundred and thirteen	twenty two thirteen
two thousand two hundred and fourteen	twenty two fourteen
two thousand two hundred and fifteen	twenty two fifteen
two thousand two hundred and sixteen	twenty two sixteen
two thousand two hundred and seventeen	twenty two seventeen
two thousand two hundred and eighteen	twenty two eighteen
two thousand two hundred and nineteen	twenty two nineteen
two thousand two hundred and twenty	twenty two twenty
two thousand two hundred and twenty one	twenty two twenty one
two thousand two hundred and twenty two	twenty two twenty two
two thousand two hundred and twenty three	twenty two twenty three
two thousand two hundred and twenty four	twenty two twenty four
two thousand two hundred and twenty five	twenty two twenty five
two thousand two hundred and twenty six	twenty two twenty six
two thousand two hundred and twenty seven	twenty two twenty seven
two thousand two hundred and twenty eight	twenty two twenty eight
two thousand two hundred and twenty nine	twenty two twenty nine
two thousand two hundred and thirty	twenty two thirty
two thousand two hundred and thirty one	twenty two thirty one
two thousand two hundred and thirty two	twenty two thirty two
two thousand two hundred and thirty three	twenty two thirty three
two thousand two hundred and thirty four	twenty two thirty four
two thousand two hundred and thirty five	twenty two thirty five
two thousand two hundred and thirty six	twenty two thirty six
two thousand two hundred and thirty seven	twenty two thirty seven
two thousand two hundred and thirty eight	twenty two thirty eight
two thousand two hundred and thirty nine	twenty two thirty nine
two thousand two hundred and forty	twenty two forty
two thousand two hundred and forty one	twenty two forty one
two thousand two hundred and forty two	twenty two forty two
two thousand two hundred and forty three	twenty two forty three
two thousand two hundred and forty four	twenty two forty four
two thousand two hundred and forty five	twenty two forty five
two thousand two hundred and forty six	twenty two forty six
two thousand two hundred and forty seven	twenty two forty seven
two thousand two hundred and forty eight	twenty two forty eight
two thousand two hundred and forty nine	twenty two forty nine
two thousand two hundred and fifty	twenty two fifty
two thousand two hundred and fifty one	twenty two fifty one
two thousand two hundred and fifty two	twenty two fifty two
two thousand two hundred and fifty three	twenty two fifty three
two thousand two hundred and fifty four	twenty two fifty four
two thousand two hundred and fifty five	twenty two fifty five
two thousand two hundred and fifty six	twenty two fifty six
two thousand two hundred and fifty seven	twenty two fifty seven
two thousand two hundred and fifty eight	twenty two fifty eight
two thousand two hundred and fifty nine	twenty two fifty nine
two thousand two hundred and sixty	twenty two sixty
two thousand two hundred and sixty one	twenty two sixty one
two thousand two hundred and sixty two	twenty two sixty two
two thousand two hundred and sixty three	twenty two sixty three
two thousand two hundred and sixty four	twenty two sixty four
two thousand two hundred and sixty five	twenty two sixty five
two thousand two hundred and sixty six	twenty two sixty six
two thousand two hundred and sixty seven	twenty two sixty seven
two thousand two hundred and sixty eight	twenty two sixty eight
two thousand two hundred and sixty nine	twenty two sixty nine
two thousand two hundred and seventy	twenty two seventy
two thousand two hundred and seventy one	twenty two seventy one
two thousand two hundred and seventy two	twenty two seventy two
two thousand two hundred and seventy three	twenty two seventy three
two thousand two hundred and seventy four	twenty two seventy four
two thousand two hundred and seventy five	twenty two seventy five
two thousand two hundred and seventy six	twenty two seventy six
two thousand two hundred and seventy seven	twenty two seventy seven
two thousand two hundred and seventy eight	twenty two seventy eight
two thousand two hundred and seventy nine	twenty two seventy nine
two thousand two hundred and eighty	twenty two eighty
two thousand two hundred and eighty one	twenty two eighty one
two thousand two hundred and eighty two	twenty two eighty two
two thousand two hundred and eighty three	twenty two eighty three
two thousand two hundred and eighty four	twenty two eighty four
two thousand two hundred and eighty five	twenty two eighty five
two thousand two hundred and eighty six	twenty two eighty six
two thousand two hundred and eighty seven	twenty two eighty seven
two thousand two hundred and eighty eight	twenty two eighty eight
two thousand two hundred and eighty nine	twenty two eighty nine
two thousand two hundred and ninety	twenty two ninety
two thousand two hundred and ninety one	twenty two ninety one
two thousand two hundred and ninety two	twenty two ninety two
two thousand two hundred and ninety three	twenty two ninety three
two thousand two hundred and ninety four	twenty two ninety four
two thousand two hundred and ninety five	twenty two ninety five
two thousand two hundred and ninety six	twenty two ninety six
two thousand two hundred and ninety seven	twenty two ninety seven
two thousand two hundred and ninety eight	twenty two ninety eight
two thousand two hundred and ninety nine	twenty two ninety nine
two thousand three hundred	twenty three hundred
two thousand three hundred and one	twenty three oh one
two thousand three hundred and two	twenty three oh two
two thousand three hundred and three	twenty three oh three
two thousand three hundred and four	twenty three oh four
two thousand three hundred and five	twenty three oh five
two thousand three hundred and six	twenty three oh six
two thousand three hundred and seven	twenty three oh seven
two thousand three hundred and eight	twenty three oh eight
two thousand three hundred and nine	twenty three oh nine
two thousand three hundred and ten	twenty three ten
two thousand three hundred and eleven	twenty three eleven
two thousand three hundred and twelve	twenty three twelve
two thousand three hundred and thirteen	twenty three thirteen
two thousand three hundred and fourteen	twenty three fourteen
two thousand three hundred and fifteen	twenty three fifteen
two thousand three hundred and sixteen	twenty three sixteen
two thousand three hundred and seventeen	twenty three seventeen
two thousand three hundred and eighteen	twenty three eighteen
two thousand three hundred and nineteen	twenty three nineteen
two thousand three hundred and twenty	twenty three twenty
two thousand three hundred and twenty one	twenty three twenty one
two thousand three hundred and twenty two	twenty three twenty two
two thousand three hundred and twenty three	twenty three twenty three
two thousand three hundred and twenty four	twenty three twenty four
two thousand three hundred and twenty five	twenty three twenty five
two thousand three hundred and twenty six	twenty three twenty six
two thousand three hundred and twenty seven	twenty three twenty seven
two thousand three hundred and twenty eight	twenty three twenty eight
two thousand three hundred and twenty nine	twenty three twenty nine
two thousand three hundred and thirty	twenty three thirty
two thousand three hundred and thirty one	twenty three thirty one
two thousand three hundred and thirty two	twenty three thirty two
two thousand three hundred and thirty three	twenty three thirty three
two thousand three hundred and thirty four	twenty three thirty four
two thousand three hundred and thirty five	twenty three thirty five
two thousand three hundred and thirty six	twenty three thirty six
two thousand three hundred and thirty seven	twenty three thirty seven
two thousand three hundred and thirty eight	twenty three thirty eight
two thousand three hundred and thirty nine	twenty three thirty nine
two thousand three hundred and forty	twenty three forty
two thousand three hundred and forty one	twenty three forty one
two thousand three hundred and forty two	twenty three forty two
two thousand three hundred and forty three	twenty three forty three
two thousand three hundred and forty four	twenty three forty four
two thousand three hundred and forty five	twenty three forty five
two thousand three hundred and forty six	twenty three forty six
two thousand three hundred and forty seven	twenty three forty seven
two thousand three hundred and forty eight	twenty three forty eight
two thousand three hundred and forty nine	twenty three forty nine
two thousand three hundred and fifty	twenty three fifty
two thousand three hundred and fifty one	twenty three fifty one
two thousand three hundred and fifty two	twenty three fifty two
two thousand three hundred and fifty three	twenty three fifty three
two thousand three hundred and fifty four	twenty three fifty four
two thousand three hundred and fifty five	twenty three fifty five
two thousand three hundred and fifty six	twenty three fifty six
two thousand three hundred and fifty seven	twenty three fifty seven
two thousand three hundred and fifty eight	twenty three fifty eight
two thousand three hundred and fifty nine	twenty three fifty nine
two thousand three hundred and sixty	twenty three sixty
two thousand three hundred and sixty one	twenty three sixty one
two thousand three hundred and sixty two	twenty three sixty two
two thousand three hundred and sixty three	twenty three sixty three
two thousand three hundred and sixty four	twenty three sixty four
two thousand three hundred and sixty five	twenty three sixty five
two thousand three hundred and sixty six	twenty three sixty six
two thousand three hundred and sixty seven	twenty three sixty seven
two thousand three hundred and sixty eight	twenty three sixty eight
two thousand three hundred and sixty nine	twenty three sixty nine
two thousand three hundred and seventy	twenty three seventy
two thousand three hundred and seventy one	twenty three seventy one
two thousand three hundred and seventy two	twenty three seventy two
two thousand three hundred and seventy three	twenty three seventy three
two thousand three hundred and seventy four	twenty three seventy four
two thousand three hundred and seventy five	twenty three seventy five
two thousand three hundred and seventy six	twenty three seventy six
two thousand three hundred and seventy seven	twenty three seventy seven
two thousand three hundred and seventy eight	twenty three seventy eight
two thousand three hundred and seventy nine	twenty three seventy nine
two thousand three hundred and eighty	twenty three eighty
two thousand three hundred and eighty one	twenty three eighty one
two thousand three hundred and eighty two	twenty three eighty two
two thousand three hundred and eighty three	twenty three eighty three
two thousand three hundred and eighty four	twenty three eighty four
two thousand three hundred and eighty five	twenty three eighty five
two thousand three hundred and eighty six	twenty three eighty six
two thousand three hundred and eighty seven	twenty three eighty seven
two thousand three hundred and eighty eight	twenty three eighty eight
two thousand three hundred and eighty nine	twenty three eighty nine
two thousand three hundred and ninety	twenty three ninety
two thousand three hundred and ninety one	twenty three ninety one
two thousand three hundred and ninety two	twenty three ninety two
two thousand three hundred and ninety three	twenty three ninety three
two thousand three hundred and ninety four	twenty three ninety four
two thousand three hundred and ninety five	twenty three ninety five
two thousand three hundred and ninety six	twenty three ninety six
two thousand three hundred and ninety seven	twenty three ninety seven
two thousand three hundred and ninety eight	twenty three ninety eight
two thousand three hundred and ninety nine	twenty three ninety nine
two thousand four hundred	twenty four hundred
two thousand four hundred and one	twenty four oh one
two thousand four hundred and two	twenty four oh two
two thousand four hundred and three	twenty four oh three
two thousand four hundred and four	twenty four oh four
two thousand four hundred and five	twenty four oh five
two thousand four hundred and six	twenty four oh six
two thousand four hundred and seven	twenty four oh seven
two thousand four hundred and eight	twenty four oh eight
two thousand four hundred and nine	twenty four oh nine
two thousand four hundred and ten	twenty four ten
two thousand four hundred and eleven	twenty four eleven
two thousand four hundred and twelve	twenty four twelve
two thousand four hundred and thirteen	twenty four thirteen
two thousand four hundred and fourteen	twenty four fourteen
two thousand four hundred and fifteen	twenty four fifteen
two thousand four hundred and sixteen	twenty four sixteen
two thousand four hundred and seventeen	twenty four seventeen
two thousand four hundred and eighteen	twenty four eighteen
two thousand four hundred and nineteen	twenty four nineteen
two thousand four hundred and twenty	twenty four twenty
two thousand four hundred and twenty one	twenty four twenty one
two thousand four hundred and twenty two	twenty four twenty two
two thousand four hundred and twenty three	twenty four twenty three
two thousand four hundred and twenty four	twenty four twenty four
two thousand four hundred and twenty five	twenty four twenty five
two thousand four hundred and twenty six	twenty four twenty six
two thousand four hundred and twenty seven	twenty four twenty seven
two thousand four hundred and twenty eight	twenty four twenty eight
two thousand four hundred and twenty nine	twenty four twenty nine
two thousand four hundred and thirty	twenty four thirty
two thousand four hundred and thirty one	twenty four thirty one
two thousand four hundred and thirty two	twenty four thirty two
two thousand four hundred and thirty three	twenty four thirty three
two thousand four hundred and thirty four	twenty four thirty four
two thousand four hundred and thirty five	twenty four thirty five
two thousand four hundred and thirty six	twenty four thirty six
two thousand four hundred and thirty seven	twenty four thirty seven
two thousand four hundred and thirty eight	twenty four thirty eight
two thousand four hundred and thirty nine	twenty four thirty nine
two thousand four hundred and forty	twenty four forty
two thousand four hundred and forty one	twenty four forty one
two thousand four hundred and forty two	twenty four forty two
two thousand four hundred and forty three	twenty four forty three
two thousand four hundred and forty four	twenty four forty four
two thousand four hundred and forty five	twenty four forty five
two thousand four hundred and forty six	twenty four forty six
two thousand four hundred and forty seven	twenty four forty seven
two thousand four hundred and forty eight	twenty four forty eight
two thousand four hundred and forty nine	twenty four forty nine
two thousand four hundred and fifty	twenty four fifty
two thousand four hundred and fifty one	twenty four fifty one
two thousand four hundred and fifty two	twenty four fifty two
two thousand four hundred and fifty three	twenty four fifty three
two thousand four hundred and fifty four	twenty four fifty four
two thousand four hundred and fifty five	twenty four fifty five
two thousand four hundred and fifty six	twenty four fifty six
two thousand four hundred and fifty seven	twenty four fifty seven
two thousand four hundred and fifty eight	twenty four fifty eight
two thousand four hundred and fifty nine	twenty four fifty nine
two thousand four hundred and sixty	twenty four sixty
two thousand four hundred and sixty one	twenty four sixty one
two thousand four hundred and sixty two	twenty four sixty two
two thousand four hundred and sixty three	twenty four sixty three
two thousand four hundred and sixty four	twenty four sixty four
two thousand four hundred and sixty five	twenty four sixty five
two thousand four hundred and sixty six	twenty four sixty six
two thousand four hundred and sixty seven	twenty four sixty seven
two thousand four hundred and sixty eight	twenty four sixty eight
two thousand four hundred and sixty nine	twenty four sixty nine
two thousand four hundred and seventy	twenty four seventy
two thousand four hundred and seventy one	twenty four seventy one
two thousand four hundred and seventy two	twenty four seventy two
two thousand four hundred and seventy three	twenty four seventy three
two thousand four hundred and seventy four	twenty four seventy four
two thousand four hundred and seventy five	twenty four seventy five
two thousand four hundred and seventy six	twenty four seventy six
two thousand four hundred and seventy seven	twenty four seventy seven
two thousand four hundred and seventy eight	twenty four seventy eight
two thousand four hundred and seventy nine	twenty four seventy nine
two thousand four hundred and eighty	twenty four eighty
two thousand four hundred and eighty one	twenty four eighty one
two thousand four hundred and eighty two	twenty four eighty two
two thousand four hundred and eighty three	twenty four eighty three
two thousand four hundred and eighty four	twenty four eighty four
two thousand four hundred and eighty five	twenty four eighty five
two thousand four hundred and eighty six	twenty four eighty six
two thousand four hundred and eighty seven	twenty four eighty seven
two thousand four hundred and eighty eight	twenty four eighty eight
two thousand four hundred and eighty nine	twenty four eighty nine
two thousand four hundred and ninety	twenty four ninety
two thousand four hundred and ninety one	twenty four ninety one
two thousand four hundred and ninety two	twenty four ninety two
two thousand four hundred and ninety three	twenty four ninety three
two thousand four hundred and ninety four	twenty four ninety four
two thousand four hundred and ninety five	twenty four ninety five
two thousand four hundred and ninety six	twenty four ninety six
two thousand four hundred and ninety seven	twenty four ninety seven
two thousand four hundred and ninety eight	twenty four ninety eight
two thousand four hundred and ninety nine	twenty four ninety nine
