O 2 O	O2O
P 2 P	P2P
C D	CD
a.m.	am
am.	am
AM	am
Am	am
p.m.	pm
pm.	pm
Pm	pm
a t m 	ATM
atm	ATM
Atm	ATM
ufo	UFO
Ufo	UFO
u f o	UFO
m v	MV
mv	MV
F I F A	FIFA
f i f a	FIFA
fifa	FIFA
nba	NBA
Nba	NBA
n b a	NBA
xL	XL
xxL	XXL
xxxL	XXXL
Q Q	QQ
gpu	GPU
cpu	CPU
wifi	WIFI
ms	MS
ceo	CEO
c e o	CEO
dv	DV
d v	DV
wto	WTO
w t o 	WTO
pc	PC
p c	PC
gps	GPS
M.V.P	MVP
mvp	MVP
vip	VIP
cba	CBA
c b a	CBA
mba	MBA
m b a	MBA
iq	IQ
I Q	IQ
E Q	EQ
cctv	CCTV
kfc	KFC
