在2014年的时候呢开始这个做这个数字货币的这个项目，成立了项目组。	在二零一四年的时候呢开始这个做这个数字货币的这个项目，成立了项目组。
在2016年呢这个这个人民银行呢成立了数字货币研究所。	在二零一六年呢这个这个人民银行呢成立了数字货币研究所。
那么2017年呢这个开始进行这个数字人民币的研发。	那么二零一七年呢这个开始进行这个数字人民币的研发。
那么2020年呢我们看到呢就是有4+1的这个试点呢开始进行推进。	那么二零二零年呢我们看到呢就是有四加一的这个试点呢开始进行推进。
雄安小一点，成都是1650万人。	雄安小一点，成都是一千六百五十万人。
其中深深圳呢是1340万人，苏州是1075万人。	其中深深圳呢是一千三百四十万人，苏州是一千零七十五万人。
那么这个呢也是想说明，呢所以对中国来讲呢是4个城市。	那么这个呢也是想说明，呢所以对中国来讲呢是四个城市。
占到这个这个15%左右的这个比重。	占到这个这个百分之十五左右的这个比重。
比重呢已经是比较高了，那么2020年呢可能就将近60%了。	比重呢已经是比较高了，那么二零二零年呢可能就将近百分之六十了。
那么再有呢就是2019年移动支付占个人消费支出的这个比重呢超过了60%。	那么再有呢就是二零一九年移动支付占个人消费支出的这个比重呢超过了百分之六十。
现在大家都在讨论5g。	现在大家都在讨论五g。
那么你拿中国的例子来讲讲，呢过去呢我们什么第3代人民币切换到第4代人民币，第4代切换到第5代。	那么你拿中国的例子来讲讲，呢过去呢我们什么第三代人民币切换到第四代人民币，第四代切换到第五代。
这个每个切换都要10年左右，然后以后还有很多遗留问题。	这个每个切换都要十年左右，然后以后还有很多遗留问题。
唉我在这里呢说就是我个人呢曾经很喜欢那个就是移动电话这个4G系统的时候。	唉我在这里呢说就是我个人呢曾经很喜欢那个就是移动电话这个四G系统的时候。
干了多少年以后，最后还是出了5g。	干了多少年以后，最后还是出了五g。
你也不能100%协调协调。好，所以有时候呢它会出现差异。	你也不能百分之一百协调协调。好，所以有时候呢它会出现差异。
我们在这儿想说一下呢就是上面所所所说的这些这个开发的思路。	我们在这想说一下呢就是上面所所所说的这些这个开发的思路。
人民银行它已经体会到唉这事儿呢可能不那么简单。	人民银行它已经体会到唉这事呢可能不那么简单。
我是7:10开始的，我觉得我还是可以讲完的。	我是七:十开始的，我觉得我还是可以讲完的。
这个我周围这些同事们呢他们的主我听到的主要意见，就是唉不要着急，马上搞搞这个事儿。	这个我周围这些同事们呢他们的主我听到的主要意见，就是唉不要着急，马上搞搞这个事。
大家也说就是说特别是08年危机出现的情况下，那时候。	大家也说就是说特别是零八年危机出现的情况下，那时候。
可能还唉这个事儿还是要做恰当的这个这个这个这个分析。	可能还唉这个事还是要做恰当的这个这个这个这个分析。
对于这个 m0和m1或者说现超数字货币和这个其他账户之间的关系。	对于这个 m零和m一或者说现超数字货币和这个其他账户之间的关系。
2020那个民营企业500强颁布的时候，我有过一个发言。	二零二零那个民营企业五百强颁布的时候，我有过一个发言。
播这个时间很短，是20分钟，那么今天呢这个时间略长一点，所以我可以把一些看法呢稍微讲的详细一点。	播这个时间很短，是二十分钟，那么今天呢这个时间略长一点，所以我可以把一些看法呢稍微讲的详细一点。
要比所有这些年度性的事件还要更加深刻一点。因为它跟我们改革开放40年来。	要比所有这些年度性的事件还要更加深刻一点。因为它跟我们改革开放四十年来。
如果说40年前中国视频当年的贫穷加上改革开放。	如果说四十年前中国视频当年的贫穷加上改革开放。
举两个印象非常深的例子，2008年是美国金融危机爆发的那一年。	举两个印象非常深的例子，二零零八年是美国金融危机爆发的那一年。
这个美国的这个华尔街把全球经济烧了这么大的洞，但就在2008年美国有一家公司就是苹果公司。	这个美国的这个华尔街把全球经济烧了这么大的洞，但就在二零零八年美国有一家公司就是苹果公司。
那我们的底下呢跟40年前有很大的变化，40年前比中国穷的国家有很多。	那我们的底下呢跟四十年前有很大的变化，四十年前比中国穷的国家有很多。
我从2017年也在深圳讨论的时候提出过这个中国经济要突围，为什么要突围呢就是被围住了。	我从二零一七年也在深圳讨论的时候提出过这个中国经济要突围，为什么要突围呢就是被围住了。
从90年代早期的时候，几百亿美元这种储备变成几万亿美元储备。	从九十年代早期的时候，几百亿美元这种储备变成几万亿美元储备。
好的很当中潜伏的危机呢有过两次爆发，第一次我刚才提到过就是08年金融危机。	好的很当中潜伏的危机呢有过两次爆发，第一次我刚才提到过就是零八年金融危机。
最后把全球金融烧了很大的库，那么从17年以后呢就开始中美贸易战了。	最后把全球金融烧了很大的库，那么从十七年以后呢就开始中美贸易战了。
03年04年就说全球失衡失衡的最突出表现就是蓝颜色美国的逆差，红颜色是中国的顺差。	零三年零四年就说全球失衡失衡的最突出表现就是蓝颜色美国的逆差，红颜色是中国的顺差。
1978年之前的全球二战以后大概就这个局面。	一九七八年之前的全球二战以后大概就这个局面。
"3300人来争那个100,010块钱的资本。"	三千三百人来争那个十万零一十块钱的资本。
这是法国年轻的经济学家写的这本，有名的书叫21世纪资本论。	这是法国年轻的经济学家写的这本，有名的书叫二十一世纪资本论。
19世纪有一本马克思的资本论，那是原始积累和早期资本主义时候的。	十九世纪有一本马克思的资本论，那是原始积累和早期资本主义时候的。
0.5左右，这是非常危险的这种基尼系数。	零点五左右，这是非常危险的这种基尼系数。
那最后就所谓99对1/900人口的这个矛盾。	那最后就所谓九十九对九百分之一人口的这个矛盾。
我2016年在美国做访问研究的城市问题，它离纽约不远，开车一个多小时。	我二零一六年在美国做访问研究的城市问题，它离纽约不远，开车一个多小时。
因为进了一块美元就得有6块7块8块人民币付出去把这个美元买过来。	因为进了一块美元就得有六块七块八块人民币付出去把这个美元买过来。
税收增加16.7倍，非税的政府收入增加18倍。	税收增加十六点七倍，非税的政府收入增加十八倍。
社保缴纳增加28.7倍，最厉害就是我们这块土地出让金增加了64倍。	社保缴纳增加二十八点七倍，最厉害就是我们这块土地出让金增加了六十四倍。
然后我们还有成本，不是市场竞争的成本，法定的成本，对不对？你看我们从95~2012高速成长期间。	然后我们还有成本，不是市场竞争的成本，法定的成本，对不对？你看我们从九十五到二零一二高速成长期间。
民意的GDP增长了8.6倍，就是不做价格指数调整的工资总额增加了8.8倍。	民意的GDP增长了八点六倍，就是不做价格指数调整的工资总额增加了八点八倍。
所以你看我们这个增长速度，大家看对不对？就是12008~10年就发生阶段性变化。	所以你看我们这个增长速度，大家看对不对？就是一二零零八到十年就发生阶段性变化。
从平均9~10的增长速度一个台阶就到了666.566左右。	从平均九到十的增长速度一个台阶就到了六百六十六点五六六左右。
也是我们07年以来讨论，17年以来讨论这个突围两个主要方向，一个方向。	也是我们零七年以来讨论，十七年以来讨论这个突围两个主要方向，一个方向。
毛主席50年的时候讲过说中国会造什么？会造椅子板凳。	毛主席五十年的时候讲过说中国会造什么？会造椅子板凳。
对不对？当年是要靠苏联156个项目，才让中国工业开始奠定这个近代以来一直没有奠定过的基础。	对不对？当年是要靠苏联一百五十六个项目，才让中国工业开始奠定这个近代以来一直没有奠定过的基础。
第4个阶段这是最近三年我们在佛山研究的题目。	第四个阶段这是最近三年我们在佛山研究的题目。
但是2017年以来，全球竞争的格局提醒我们注意还要再跳一步。	但是二零一七年以来，全球竞争的格局提醒我们注意还要再跳一步。
中国60年报原子弹的时候，美国的原子弹四五年就爆了。	中国六十年报原子弹的时候，美国的原子弹四五年就爆了。
45年的原子弹最早是科学家的论文，是39年的论文。	四十五年的原子弹最早是科学家的论文，是三十九年的论文。
这个想法可能在经验当中产生，但17世纪以后大量是科学基础研究以后的这个派生物。	这个想法可能在经验当中产生，但十七世纪以后大量是科学基础研究以后的这个派生物。
所以中国面临一个很大的未来，往未来5年10年看。	所以中国面临一个很大的未来，往未来五年十年看。
他是48年建国的一个小国家，我们是49年建国一个大国家，以色列的和平环境比我们差得远。	他是四十八年建国的一个小国家，我们是四十九年建国一个大国家，以色列的和平环境比我们差得远。
所以我老问这个问题，今天我们是看到了芯片是个懒累，那5年以后什么是懒累？	所以我老问这个问题，今天我们是看到了芯片是个懒累，那五年以后什么是懒累？
64年我们爆发原子弹的时候，原子弹这个独到性我们已经突破了，可是60年时候还没有芯片。	六四年我们爆发原子弹的时候，原子弹这个独到性我们已经突破了，可是六零年时候还没有芯片。
那未来5年10年还会冒出什么别的东西来。中国在这个领域在这个方向上。	那未来五年十年还会冒出什么别的东西来。中国在这个领域在这个方向上。
深圳发现以后，把他拉到深圳来，已经在这个关外投了很100多个亿量产。	深圳发现以后，把他拉到深圳来，已经在这个关外投了很一百多个亿量产。
问题是华为的研发系统敏感，10年前土耳其科学家这篇关于集号码的论文。	问题是华为的研发系统敏感，十年前土耳其科学家这篇关于集号码的论文。
要在这个基础上再往前提出一个要求，5年10年。	要在这个基础上再往前提出一个要求，五年十年。
所以你看今年公布的这个民营500强那个门槛，哇跟去年跟跟10年前大幅度提高。	所以你看今年公布的这个民营五百强那个门槛，哇跟去年跟跟十年前大幅度提高。
经济机器是怎样运行的，时长30分钟。	经济机器是怎样运行的，时长三十分钟。
其中一个周期持续大约5年至8年，另一个持续大约75年至100年。	其中一个周期持续大约五年至八年，另一个持续大约七十五年至一百年。
美国国内的信贷总额大约为50万亿美元，而货币总额只有大约3万亿美元。	美国国内的信贷总额大约为五十万亿美元，而货币总额只有大约三万亿美元。
我举一个例子，假设你每年挣10万美元，没有任何债务。	我举一个例子，假设你每年挣十万美元，没有任何债务。
由于你的支出是别人的收入，另一个人因此挣了11万美元。	由于你的支出是别人的收入，另一个人因此挣了十一万美元。
这个挣了11万美元的人，如果没有任何债务可以借1.1万美元。	这个挣了十一万美元的人，如果没有任何债务可以借一点一万美元。
他可以消费12.1万美元，即使他的年收入只有11万美元。	他可以消费十二点一万美元，即使他的年收入只有十一万美元。
短期债务周期通常持续5~8年，在几十年里不断重复。	短期债务周期通常持续五到八年，在几十年里不断重复。
日本在1989年和美国在1929年因同样原因发生了这一情况。	日本在一九八九年和美国在一九二九年因同样原因发生了这一情况。
美国、欧洲和世界上很多其他地区在2008年即发生的这一情况。	美国、欧洲和世界上很多其他地区在二零零八年即发生的这一情况。
美国国内的利率在1930年代的去杠杆化期间下降到0，在2008年也是如此。	美国国内的利率在一九三零年代的去杠杆化期间下降到零，在二零零八年也是如此。
但是在去杠杆化过程中，由于利率已经很低，接近0，从而丧失刺激功能，因此降低利率不起作用。	但是在去杠杆化过程中，由于利率已经很低，接近零，从而丧失刺激功能，因此降低利率不起作用。
为此可以采用4种办法一，个人企业和政府削减支出。	为此可以采用四种办法一，个人企业和政府削减支出。
这4种办法被用于现代历史上的每一个去杠杆化过程。	这四种办法被用于现代历史上的每一个去杠杆化过程。
我们再次以98为例，当你用赊账的办法买一瓶啤酒时，是在承诺今后偿还酒吧的赊账。	我们再次以九十八为例，当你用赊账的办法买一瓶啤酒时，是在承诺今后偿还酒吧的赊账。
这种情况发生在美国大萧条期间，并于2008年再次爆发。	这种情况发生在美国大萧条期间，并于二零零八年再次爆发。
当时美国的中央银行及联邦储备委员会增加发行了2万多亿美元。	当时美国的中央银行及联邦储备委员会增加发行了二万多亿美元。
央行已经把利率降到接近0的水平，现在不得不发行更多货币。	央行已经把利率降到接近零的水平，现在不得不发行更多货币。
决策者需要平衡考虑降低债务负担的4种办法。	决策者需要平衡考虑降低债务负担的四种办法。
例如我们假设有个国家正在经历去杠杆化，其债务收入比率是100%。	例如我们假设有个国家正在经历去杠杆化，其债务收入比率是百分之一百。
假设这些债务的利率是2%。	假设这些债务的利率是百分之二。
如果债务以2%的利率速度增加，而收入的增长率仅有大约1%，那么债务负担永远不会减轻。	如果债务以百分之二的利率速度增加，而收入的增长率仅有大约百分之一，那么债务负担永远不会减轻。
为了使债务负担下降和经济活动恢复正常，大约需要10年或更长的时间，因此有失去的十年这种说法。	为了使债务负担下降和经济活动恢复正常，大约需要十年或更长的时间，因此有失去的十年这种说法。
白俄罗斯钦佩中华人民共和国成立70年来取得的辉煌成就。	白俄罗斯钦佩中华人民共和国成立七十年来取得的辉煌成就。
国家主席习近平当地时间14号乘专机抵达杜尚别，开始出席亚洲相互协作与信任措施会议第5次峰会。	国家主席习近平当地时间十四号乘专机抵达杜尚别，开始出席亚洲相互协作与信任措施会议第五次峰会。
建交27年来，中塔关系始终保持健康稳定发展。	建交二十七年来，中塔关系始终保持健康稳定发展。
2017年我和拉赫蒙总统共同决定建立中塔全面战略伙伴关系，两国关系进入快速发展新阶段。	二零一七年我和拉赫蒙总统共同决定建立中塔全面战略伙伴关系，两国关系进入快速发展新阶段。
习近平指出，时隔5年再度踏上这片古老而神奇的土地。	习近平指出，时隔五年再度踏上这片古老而神奇的土地。
拉赫蒙愉快地回忆起习近平5年前来塔吉克斯坦访问的情景。	拉赫蒙愉快地回忆起习近平五年前来塔吉克斯坦访问的情景。
王岐山出席第6届中国俄罗斯博览会，并会见俄罗斯副总理。	王岐山出席第六届中国俄罗斯博览会，并会见俄罗斯副总理。
习近平指出，亚信成立27年来，致力于增进各国互信和协作，维护地区安全和稳定。	习近平指出，亚信成立二十七年来，致力于增进各国互信和协作，维护地区安全和稳定。
2015年我提出构筑亚洲命运共同体倡议新形势下我们要坚持既定目标，共赢机遇共对挑战。	二零一五年我提出构筑亚洲命运共同体倡议新形势下我们要坚持既定目标，共赢机遇共对挑战。
要摒弃0和博弈保护主义，加强政策沟通，增进政治互信，逐步扩大战略共识。	要摒弃零和博弈保护主义，加强政策沟通，增进政治互信，逐步扩大战略共识。
我们要共同推动贸易和投资自由化便利化，落实今年4月第二届一带一路国际合作高峰论坛共识。	我们要共同推动贸易和投资自由化便利化，落实今年四月第二届一带一路国际合作高峰论坛共识。
建设开放包容的亚洲是我们的共同追求。我们要落实好今年5月亚洲文明对话大会共识。	建设开放包容的亚洲是我们的共同追求。我们要落实好今年五月亚洲文明对话大会共识。
各位观众，今天的新闻联播节目大约需要57分钟，一下来看详细报道。	各位观众，今天的新闻联播节目大约需要五十七分钟，一下来看详细报道。
中方将继续在和平共处5项原则基础上深化同各国的友好合作。	中方将继续在和平共处五项原则基础上深化同各国的友好合作。
上海合作组织成员国元首理事会第19次会议，当地时间6月14号在吉尔吉斯斯坦首都比什凯克举行。	上海合作组织成员国元首理事会第十九次会议，当地时间六月十四号在吉尔吉斯斯坦首都比什凯克举行。
习近平指出，今年1月埃米尔殿下对中国进行国事访问，我们就新形势下推动中卡战略伙伴关系发展。	习近平指出，今年一月埃米尔殿下对中国进行国事访问，我们就新形势下推动中卡战略伙伴关系发展。
峰会发表了亚洲相互协作与信任措施。会议第5次峰会宣言。	峰会发表了亚洲相互协作与信任措施。会议第五次峰会宣言。
双方要加快推进在能源经贸基础设施建设投资，第5代移动通信等领域的全方位合作。	双方要加快推进在能源经贸基础设施建设投资，第五代移动通信等领域的全方位合作。
今天是6月15号，星期六农历5月13，欢迎收看新闻联播节目。	今天是六月十五号，星期六农历五月十三，欢迎收看新闻联播节目。
塔米姆表示，卡中关系是战略性的，我今年1月访华非常成功。	塔米姆表示，卡中关系是战略性的，我今年一月访华非常成功。
本台消息6月16号出版的第12期求是杂志，将发表中共中央总书记国家主席。	本台消息六月十六号出版的第十二期求是杂志，将发表中共中央总书记国家主席。
中土都是20国集团重要成员，双方要加强在20国集团等多边领域的沟通协调。	中土都是二十国集团重要成员，双方要加强在二十国集团等多边领域的沟通协调。
中国特色社会主义文化源自于中华民族5000多年文明历史所孕育的中华优秀传统文化。	中国特色社会主义文化源自于中华民族五千多年文明历史所孕育的中华优秀传统文化。
并发表主旨演讲表示，值此中俄建交70周年，两国元首共同宣布。	并发表主旨演讲表示，值此中俄建交七十周年，两国元首共同宣布。
国家副主席王岐山6月14号在哈尔滨会见了俄罗斯副总理阿基莫夫。王岐山表示。	国家副主席王岐山六月十四号在哈尔滨会见了俄罗斯副总理阿基莫夫。王岐山表示。
原知识产权5条热线和平台的整合，实现12315一个号码对外一个平台受理，方便消费者。	原知识产权五条热线和平台的整合，实现一二三一五一个号码对外一个平台受理，方便消费者。
习近平总书记向2019中国西藏发展论坛发来的贺信，在会场内外及西藏各族群众中引起热烈反响。	习近平总书记向二零一九中国西藏发展论坛发来的贺信，在会场内外及西藏各族群众中引起热烈反响。
构建更加紧密的上海合作组织命运共同体。这是习主席继去年上合组织青岛峰会提出5项建议之后。	构建更加紧密的上海合作组织命运共同体。这是习主席继去年上合组织青岛峰会提出五项建议之后。
香港特区行政长官林正月娥15号宣布特区政府决定暂缓修订逃犯条例的工作。	香港特区行政长官林正月娥十五号宣布特区政府决定暂缓修订逃犯条例的工作。
2019年逃犯及刑事事宜相互法律协助法律修订条例草案。	二零一九年逃犯及刑事事宜相互法律协助法律修订条例草案。
该发言人表示，今年2月香港特别行政区政府启动与移交逃犯相关的两个条例修订工作。	该发言人表示，今年二月香港特别行政区政府启动与移交逃犯相关的两个条例修订工作。
这包括让社会尽快恢复平静，以及避免再有执法人员和市民受到伤害。特区政府今年4月向立法会提交了。	这包括让社会尽快恢复平静，以及避免再有执法人员和市民受到伤害。特区政府今年四月向立法会提交了。
本台消息外交部发言人耿爽15号就香港特别行政区修订与移交逃犯相关的两个条例问题发表谈话。	本台消息外交部发言人耿爽十五号就香港特别行政区修订与移交逃犯相关的两个条例问题发表谈话。
今年2月香港特区政府提出修订逃犯条例和刑事事宜相互法律协助条例以来，得到香港主流民意支持。	今年二月香港特区政府提出修订逃犯条例和刑事事宜相互法律协助条例以来，得到香港主流民意支持。
对联邦快递未按明知投递快递行为，国家有关部门在6月1号宣布决定立案调查联邦快递。	对联邦快递未按明知投递快递行为，国家有关部门在六月一号宣布决定立案调查联邦快递。
14号国家有关部门向联邦快递中国有限公司送达了询问通知书，专家表示案件已经进入调查阶段。	十四号国家有关部门向联邦快递中国有限公司送达了询问通知书，专家表示案件已经进入调查阶段。
今年前5个月出入内蒙古二连浩特铁路口岸的中欧班列数量达到614列，同比增长34.6%。	今年前五个月出入内蒙古二连浩特铁路口岸的中欧班列数量达到六百一十四列，同比增长百分之三十四点六。
回程重载率达到了100%。内蒙古二连浩特铁路口岸是中欧班列中线通道的出境口岸。	回程重载率达到了百分之一百。内蒙古二连浩特铁路口岸是中欧班列中线通道的出境口岸。
中华人民共和国行政处罚法第37条明确规定。	中华人民共和国行政处罚法第三十七条明确规定。
第10届国际空间轨道设计大赛近日揭晓，国防科技大学与西安卫星测控中心连队以绝对优势首次荣获冠军。	第十届国际空间轨道设计大赛近日揭晓，国防科技大学与西安卫星测控中心连队以绝对优势首次荣获冠军。
该赛事是世界航天领域的高水平专业性竞赛，本届比赛全球共有73支专业队伍参赛，规模为历届之最。	该赛事是世界航天领域的高水平专业性竞赛，本届比赛全球共有七十三支专业队伍参赛，规模为历届之最。
13号，包括美国最大超市沃尔玛在内的超过600家企业和协会联名致信美国政府。	十三号，包括美国最大超市沃尔玛在内的超过六百家企业和协会联名致信美国政府。
这封信由520家美国企业和141个贸易协会共同签署。信中说。	这封信由五百二十家美国企业和一百四十一个贸易协会共同签署。信中说。
习近平出席上海合作组织成员国元首理事会第19次会议，并发表重要讲话，强调秉持上海精神。	习近平出席上海合作组织成员国元首理事会第十九次会议，并发表重要讲话，强调秉持上海精神。
信函援引一项研究结果说，如果对额外3000亿美元中国输美商品加征关税，加上已经生效的加征关税举措。	信函援引一项研究结果说，如果对额外三千亿美元中国输美商品加征关税，加上已经生效的加征关税举措。
将导致美国损失200万个就业岗位，国内生产总值减少1%。	将导致美国损失两百万个就业岗位，国内生产总值减少百分之一。
本月12号由美国大型企业高管组成的商业圆桌会议发布的调查结果也显示。	本月十二号由美国大型企业高管组成的商业圆桌会议发布的调查结果也显示。
第二季度经济展望指数下跌5.7点至89.5点。	第二季度经济展望指数下跌五点七点至八十九点五点。
14号印度时报等多家媒体报道称，印度将从16号起对包括杏仁、核桃、豆类。	十四号印度时报等多家媒体报道称，印度将从十六号起对包括杏仁、核桃、豆类。
和铁板杂志产品在内的29种美国产品征收额外关税，加征后的税率最高达120%。	和铁板杂志产品在内的二十九种美国产品征收额外关税，加征后的税率最高达百分之一百二十。
涉及美方大约2.2亿美元的商品。印度财政部将很快发布相关通知，2018年3月。	涉及美方大约二点二亿美元的商品。印度财政部将很快发布相关通知，二零一八年三月。
从6月5号起终止印度普惠制待遇。	从六月五号起终止印度普惠制待遇。
13号两艘油轮在阿曼湾海域预习。	十三号两艘油轮在阿曼湾海域预习。
13号一枚火箭弹从加沙地带发射至以色列境内，造成房屋受损。	十三号一枚火箭弹从加沙地带发射至以色列境内，造成房屋受损。
第6届南欧峰会14号在马耳他首都瓦莱塔举行。	第六届南欧峰会十四号在马耳他首都瓦莱塔举行。
与会7国领导人表示，将共同努力缓解气候变化对地中海地区的影响，并解决非法移民问题。	与会七国领导人表示，将共同努力缓解气候变化对地中海地区的影响，并解决非法移民问题。
习近平出席中俄蒙元首第5次会晤。	习近平出席中俄蒙元首第五次会晤。
以及关于信息通信、技术、禁毒地方合作等13个合作文件。	以及关于信息通信、技术、禁毒地方合作等十三个合作文件。
国家主席习近平当地时间14号在比什凯克同俄罗斯总统普京，蒙古国总统巴特图勒嘎。	国家主席习近平当地时间十四号在比什凯克同俄罗斯总统普京，蒙古国总统巴特图勒嘎。
举行中俄蒙三国元首第5次会晤。三国元首总结三方合作成果，共商全面推进合作大计。	举行中俄蒙三国元首第五次会晤。三国元首总结三方合作成果，共商全面推进合作大计。
去年6月我们在青岛举行三国元首第4次会晤以来，三方密切沟通协作，三方合作逐步深入发展。	去年六月我们在青岛举行三国元首第四次会晤以来，三方密切沟通协作，三方合作逐步深入发展。
习近平抵达杜尚别，开始出席亚洲相互协作与信任措施会议第5次峰会，并对塔吉克斯坦共和国进行国事访问。	习近平抵达杜尚别，开始出席亚洲相互协作与信任措施会议第五次峰会，并对塔吉克斯坦共和国进行国事访问。
习近平出席亚洲相互协作与信任措施会议第5次峰会，并发表重要讲话，强调共赢机遇，共对挑战。	习近平出席亚洲相互协作与信任措施会议第五次峰会，并发表重要讲话，强调共赢机遇，共对挑战。
习近平指出，今年中方将分别同俄蒙两方庆祝建交70周年，中俄蒙三方合作将迎来新的机遇。	习近平指出，今年中方将分别同俄蒙两方庆祝建交七十周年，中俄蒙三方合作将迎来新的机遇。
国家主席习近平。当地时间14号，在比斯凯克会见白俄罗斯总统卢卡申科。	国家主席习近平。当地时间十四号，在比斯凯克会见白俄罗斯总统卢卡申科。
最近半年平均每分钟中国风就会被搜索805次，是去年同期的2.5倍。	最近半年平均每分钟中国风就会被搜索八百零五次，是去年同期的二点五倍。
其中50%以上都来自90后与00后。	其中百分之五十以上都来自九零后与零零后。
仅中秋前后一个月卖出了3000多把油纸伞。	仅中秋前后一个月卖出了三千多把油纸伞。
制作油纸伞的过程，一放到直播平台上就吸引了60万粉丝。	制作油纸伞的过程，一放到直播平台上就吸引了六十万粉丝。
他带领团队奋斗40多年，攻克了世界级难题，成功研制出激光陀螺，并将科研成果转化成战斗力。	他带领团队奋斗四十多年，攻克了世界级难题，成功研制出激光陀螺，并将科研成果转化成战斗力。
这是继美法俄之后，我国成为世界上第4个能够独立研制激光陀螺的国家。	这是继美法俄之后，我国成为世界上第四个能够独立研制激光陀螺的国家。
上世纪60年代初，美国研制出世界上第一台激光陀螺仪的原理样机。	上世纪六十年代初，美国研制出世界上第一台激光陀螺仪的原理样机。
1971年时任国防科工委副主任的钱学森将激光陀螺的大致技术原理写在两张小纸片上。	一九七一年时任国防科工委副主任的钱学森将激光陀螺的大致技术原理写在两张小纸片上。
在庆祝全国人民代表大会成立60周年大会上的讲话。	在庆祝全国人民代表大会成立六十周年大会上的讲话。
1978年高博龙率领课题组成功研制出我国第一代激光陀螺实验室原理样机。	一九七八年高博龙率领课题组成功研制出我国第一代激光陀螺实验室原理样机。
当时国内顶尖镀膜机穿透率最高千分之1，制造激光陀螺起步就要万分之1。	当时国内顶尖镀膜机穿透率最高千分之一，制造激光陀螺起步就要万分之一。
美国光在解决镀膜问题上就花了近30年的时间。	美国光在解决镀膜问题上就花了近三十年的时间。
为攻克镀膜技术这一难关，高博龙把实验室当成第二个家，每天工作15个小时。	为攻克镀膜技术这一难关，高博龙把实验室当成第二个家，每天工作十五个小时。
在经历了无数次挫折与失败后，1994年11月8号，国第一台激光陀螺工程化样机诞生。	在经历了无数次挫折与失败后，一九九四年十一月八号，国第一台激光陀螺工程化样机诞生。
2013年以85岁高龄的高伯龙。	二零一三年以八十五岁高龄的高伯龙。
并提供了城市大脑、智慧社区等17个科技应用场景建设项目。	并提供了城市大脑、智慧社区等十七个科技应用场景建设项目。
今年上半年海淀区地区生产总值占到了北京全市经济总量的1/5以上。	今年上半年海淀区地区生产总值占到了北京全市经济总量的五分之一以上。
针对人工智能企业缺乏让技术落地的应用问题，推出了人工智能15条等多项新政策。	针对人工智能企业缺乏让技术落地的应用问题，推出了人工智能十五条等多项新政策。
香港最大政团民建联本月12号向特区政府提出，通过规划新发展区或公营发展项目。	香港最大政团民建联本月十二号向特区政府提出，通过规划新发展区或公营发展项目。
截至9月15号17:00，全国未发生重大及以上生产安全事故。	截至九月十五号十七点，全国未发生重大及以上生产安全事故。
节日期间，全国消防救援队伍共参加灭火和抢险救援5654起。	节日期间，全国消防救援队伍共参加灭火和抢险救援五千六百五十四起。
营救遇险被困群众869人。	营救遇险被困群众八百六十九人。
全国铁路预计发送旅客1172万人次，加开旅客列车928列。	全国铁路预计发送旅客一千一百七十二万人次，加开旅客列车九百二十八列。
从今天15点起，高速部分路段出现短时车流量大的情况。	从今天十五点起，高速部分路段出现短时车流量大的情况。
车流量拥堵程度约为平日的2.1倍。	车流量拥堵程度约为平日的二点一倍。
经过遴选推荐群众网上投票等程序，日前产生了300名建议人选。	经过遴选推荐群众网上投票等程序，日前产生了三百名建议人选。
今天起至9月20号进入公示阶段。	今天起至九月二十号进入公示阶段。
该活动是为了表彰新中国成立70年来各个不同历史时期涌现的。	该活动是为了表彰新中国成立七十年来各个不同历史时期涌现的。
是中国社会100多年激越变革激荡发展的历史结果。	是中国社会一百多年激越变革激荡发展的历史结果。
第7届全国道德模范评选表彰活动，自今年3月启动以来，按照群众推荐严格审核。	第七届全国道德模范评选表彰活动，自今年三月启动以来，按照群众推荐严格审核。
共评出58位全国道德模范和257位提名奖获得者。	共评出五十八位全国道德模范和两百五十七位提名奖获得者。
颁奖仪式专题电视节目将于今晚在我台综合频道8点档播出。	颁奖仪式专题电视节目将于今晚在我台综合频道八点档播出。
让大家知道在舞蹈、武术、中餐、茶道背后是5000年的文明。	让大家知道在舞蹈、武术、中餐、茶道背后是五千年的文明。
举行了丰富多彩的活动，庆祝即将到来的新中国70周年华诞。	举行了丰富多彩的活动，庆祝即将到来的新中国七十周年华诞。
沙特能源大臣15号表示。	沙特能源大臣十五号表示。
与会各方就筹措10亿美元资金用于打击区域恐怖主义达成一致。	与会各方就筹措十亿美元资金用于打击区域恐怖主义达成一致。
受袭击事件影响，短期内沙特将每天减产原油约570万桶。	受袭击事件影响，短期内沙特将每天减产原油约五百七十万桶。
今天是9月15号星期日，农历8月17，欢迎收看新闻联播节目。	今天是九月十五号星期日，农历八月十七，欢迎收看新闻联播节目。
对此伊朗外交部15号表示，美方的指责毫无根据。	对此伊朗外交部十五号表示，美方的指责毫无根据。
求是杂志发表习近平总书记重要文章，在庆祝全国人民代表大会成立60周年大会上的讲话。	求是杂志发表习近平总书记重要文章，在庆祝全国人民代表大会成立六十周年大会上的讲话。
系列报道爱国情奋斗者今天为您播出，高伯龙院士生前带领团队奋斗40多年，成功研制出激光陀螺。	系列报道爱国情奋斗者今天为您播出，高伯龙院士生前带领团队奋斗四十多年，成功研制出激光陀螺。
让新疆沙湾县安集海镇的4万多亩辣椒迎来了丰收。	让新疆沙湾县安集海镇的四万多亩辣椒迎来了丰收。
深圳的大街小巷悬挂了超过10万面国旗。	深圳的大街小巷悬挂了超过十万面国旗。
强化组织保障等6个方面，要求进一步营造全社会尊师重教的浓厚氛围。	强化组织保障等六个方面，要求进一步营造全社会尊师重教的浓厚氛围。
然而在中小企业超过90%的温州今年前三季度企业的研发投入占比位居浙江省第一。	然而在中小企业超过百分之九十的温州今年前三季度企业的研发投入占比位居浙江省第一。
如今在温州这样的产业创新综合体遍地开花，涵盖精密模具、印刷软件和信息智能仪器等32个领域。	如今在温州这样的产业创新综合体遍地开花，涵盖精密模具、印刷软件和信息智能仪器等三十二个领域。
企业每月就有10多款新产品上市。	企业每月就有十多款新产品上市。
今年前三季度温州技改投资规上企业研发高技术企业投资增速都超过20%。	今年前三季度温州技改投资规上企业研发高技术企业投资增速都超过百分之二十。
第4次修订的中国新闻工作者职业道德准则今天向社会公布。	第四次修订的中国新闻工作者职业道德准则今天向社会公布。
该准则共7条31款，突出指导性，强调实践性，体现时代性。	该准则共七条三十一款，突出指导性，强调实践性，体现时代性。
通知明确要以国家级贫困县，特别是14个集中连片特困区内的深度贫困县为重点，开展送文化下基层活动。	通知明确要以国家级贫困县，特别是十四个集中连片特困区内的深度贫困县为重点，开展送文化下基层活动。
通知要求所有国家级贫困县2020年上半年至少开展一场活动，基本实现全覆盖。	通知要求所有国家级贫困县二零二零年上半年至少开展一场活动，基本实现全覆盖。
2017年澳门被联合国评为创意美食之都。	二零一七年澳门被联合国评为创意美食之都。
全年700场的国际演出与展览，正在为澳门打造与世界接轨的艺术展示平台。	全年七百场的国际演出与展览，正在为澳门打造与世界接轨的艺术展示平台。
独具特色的文化为我们发展注入新动力。20年来，港澳旅客增长了4倍。	独具特色的文化为我们发展注入新动力。二十年来，港澳旅客增长了四倍。
2018年在澳门举办的会展数量超过1400场，成为澳门不断增长的新兴产业。	二零一八年在澳门举办的会展数量超过一千四百场，成为澳门不断增长的新兴产业。
今天是12月15号星期日。	今天是十二月十五号星期日。
本台消息12月16号出版的第24期求是杂志。	本台消息十二月十六号出版的第二十四期求是杂志。
每年有6500多名群众直接参与了防护类的建设管理。	每年有六千五百多名群众直接参与了防护类的建设管理。
雅江林业项目每年为群众增收2800多万元。	雅江林业项目每年为群众增收两千八百多万元。
在山谷间形成了一条平均宽度1800多米，长达160公里的绿色长廊。	在山谷间形成了一条平均宽度一千八百多米，长达一百六十公里的绿色长廊。
李谦，原名李荣光，1909年出生于湖南醴陵县城。	李谦，原名李荣光，一九零九年出生于湖南醴陵县城。
1924年春李谦和左权等同学离开家乡。	一九二四年春李谦和左权等同学离开家乡。
如今西藏山南市雅江沿岸建成防护林面积达45万亩。	如今西藏山南市雅江沿岸建成防护林面积达四十五万亩。
1929年李谦参与组织百色起义，任中国工农红军第七军一纵队司令员。	一九二九年李谦参与组织百色起义，任中国工农红军第七军一纵队司令员。
1930年4月底，他率部参加了攻克黔东荣江县城的战斗。	一九三零年四月底，他率部参加了攻克黔东荣江县城的战斗。
他指挥部队英勇反击，打退了8次进攻。在这次战斗中李谦壮烈牺牲，年仅22岁。	他指挥部队英勇反击，打退了八次进攻。在这次战斗中李谦壮烈牺牲，年仅二十二岁。
李陵事业成功获评湖南省2018届文明城市。	李陵事业成功获评湖南省二零一八届文明城市。
1931年2月3日，李谦带领的部队在广东乳源梅花村被国民党军包围。	一九三一年二月三日，李谦带领的部队在广东乳源梅花村被国民党军包围。
12月14号到20号，中央依法治国办将对河北、山西、浙江等8省展开实地督查。	十二月十四号到二十号，中央依法治国办将对河北、山西、浙江等八省展开实地督查。
在第4届世界考古论坛上，西汉海昏侯墓的考古发掘获得重大田野考古发现奖，成为唯一入选的中国项目。	在第四届世界考古论坛上，西汉海昏侯墓的考古发掘获得重大田野考古发现奖，成为唯一入选的中国项目。
全县长约74公里，共设15个客运站，设计时速140公里每小时。	全县长约七十四公里，共设十五个客运站，设计时速一百四十公里每小时。
迄今已出土1万余件套文物。	迄今已出土一万余件套文物。
诈骗团伙藏匿在越南现港、市，利用网络刷单进行诈骗，先后作案1400多起。	诈骗团伙藏匿在越南现港、市，利用网络刷单进行诈骗，先后作案一千四百多起。
中越两国警方统一行动，一举捣毁多个窝点，抓获涉案的三个团伙32人。	中越两国警方统一行动，一举捣毁多个窝点，抓获涉案的三个团伙三十二人。
文化节目一堂，好课今晚在央视综艺频道播出第5期。	文化节目一堂，好课今晚在央视综艺频道播出第五期。
经过近半年侦查，广西桂林警方日前将21名网络刷单诈骗嫌疑人从越南押解回国。	经过近半年侦查，广西桂林警方日前将二十一名网络刷单诈骗嫌疑人从越南押解回国。
针对伊拉克近几个月来持续的示威活动，联合国驻伊拉克援助团14号发表联合国安理会的媒体声明说。	针对伊拉克近几个月来持续的示威活动，联合国驻伊拉克援助团十四号发表联合国安理会的媒体声明说。
菲律宾南部棉兰老岛南达沃省今天下午发生里氏6.9级地震，随后又发生了多次余震。	菲律宾南部棉兰老岛南达沃省今天下午发生里氏六点九级地震，随后又发生了多次余震。
14号俄罗斯北极号核动力破冰船返回位于圣彼得堡的波罗的海造船厂码头，结束为期两天的首次航行试验。	十四号俄罗斯北极号核动力破冰船返回位于圣彼得堡的波罗的海造船厂码头，结束为期两天的首次航行试验。
明年5月北京号将正式首航。北京号是当前世界上动力最强的破冰船之一。	明年五月北京号将正式首航。北京号是当前世界上动力最强的破冰船之一。
联合国大会13号投票决定，将联合国近东巴勒斯坦难民救济和工程处的任务期限延长三年至2023年6月。	联合国大会十三号投票决定，将联合国近东巴勒斯坦难民救济和工程处的任务期限延长三年至二零二三年六月。
近东救济工程处主要负责向生活在约旦河西岸加沙地带等地的500多万巴勒斯坦难民提供人道主义救助。	近东救济工程处主要负责向生活在约旦河西岸加沙地带等地的五百多万巴勒斯坦难民提供人道主义救助。
农历11月20，欢迎收看新闻联播节目。	农历十一月二十，欢迎收看新闻联播节目。
到2020年我国现行标准下，农村贫困人口实现脱贫是党对人民的庄严承诺。	到二零二零年我国现行标准下，农村贫困人口实现脱贫是党对人民的庄严承诺。
今年8月，总书记曾到这里看望过大家。	今年八月，总书记曾到这里看望过大家。
他还报名修建了4座养殖暖棚。今年8月总书记曾来到他家做客。	他还报名修建了四座养殖暖棚。今年八月总书记曾来到他家做客。
依托脱贫产业的有力支撑，今年底富民新村还会有520户建档立卡贫困户脱贫摘帽。	依托脱贫产业的有力支撑，今年底富民新村还会有五百二十户建档立卡贫困户脱贫摘帽。
到2020年稳定实现农村贫困人口不愁吃不愁穿，义务教育基本医疗住房安全有保障。	到二零二零年稳定实现农村贫困人口不愁吃不愁穿，义务教育基本医疗住房安全有保障。
在夏邑县仅食用菌种植大棚就有2万多座，年产值超10亿元。	在夏邑县仅食用菌种植大棚就有二万多座，年产值超十亿元。
辐射带动贫困群众2800多户。	辐射带动贫困群众两千八百多户。
全县143个贫困村，5点万户贫困户基本实现村镇有产业后有项目。	全县一百四十三个贫困村，五点万户贫困户基本实现村镇有产业后有项目。
预计到今年底全国95%左右现行标准的贫困人口将实现脱贫。	预计到今年底全国百分之九十五左右现行标准的贫困人口将实现脱贫。
90%以上的贫困县将实现摘帽。	百分之九十以上的贫困县将实现摘帽。
本台消息，国务院总理李克强12月14号致电鲍里斯约翰逊，祝贺他连任英国首相。	本台消息，国务院总理李克强十二月十四号致电鲍里斯约翰逊，祝贺他连任英国首相。
不断促进两国民众的相互了解和友谊。巴赫塔泽祝贺新中国成立70周年，他表示。	不断促进两国民众的相互了解和友谊。巴赫塔泽祝贺新中国成立七十周年，他表示。
国务院总理李克强7月1号下午在大连会见世界经济论坛主席施瓦布。	国务院总理李克强七月一号下午在大连会见世界经济论坛主席施瓦布。
埃博拉德祝贺中国共产党成立98周年，对中国发展成就表示钦佩，他表示莫衷执政党理念相近。	埃博拉德祝贺中国共产党成立九十八周年，对中国发展成就表示钦佩，他表示莫衷执政党理念相近。
今天是中国共产党98岁华诞，各地干部群众通过重温入党誓词，诵读红色经典等多种活动。	今天是中国共产党九十八岁华诞，各地干部群众通过重温入党誓词，诵读红色经典等多种活动。
约170张图片，240多件文献资料，全面呈现早期共产主义运动在巴渝大地上的伟大实践。	约一百七十张图片，两百四十多件文献资料，全面呈现早期共产主义运动在巴渝大地上的伟大实践。
升旗仪式上午8点整准时举行。	升旗仪式上午八点整准时举行。
快评说98年风雨兼程，98年砥砺奋进，朝平暗阔催人进，风正扬帆当有为。	快评说九八年风雨兼程，九八年砥砺奋进，朝平暗阔催人进，风正扬帆当有为。
香港市民一号举行多姿多彩的活动，庆祝回归祖国的纪念日，4000多名香港市民来到香港维多利亚公园。	香港市民一号举行多姿多彩的活动，庆祝回归祖国的纪念日，四千多名香港市民来到香港维多利亚公园。
香港特区政府一号上午举行升旗仪式，庆祝香港回归祖国22周年。	香港特区政府一号上午举行升旗仪式，庆祝香港回归祖国二十二周年。
参加我爱香港主题活动，在现场他们摆出我爱香港的图案，表达对香港回归祖国22周年的喜悦心情。	参加我爱香港主题活动，在现场他们摆出我爱香港的图案，表达对香港回归祖国二十二周年的喜悦心情。
2018年3月黄文秀同志积极响应组织号召，到乐业县白泥村担任驻村第一书记。	二零一八年三月黄文秀同志积极响应组织号召，到乐业县白泥村担任驻村第一书记。
来自100多个国家和地区的1800多名嘉宾将围绕领导力4.0全球化新时代的成功之道展开200多场讨论。	来自一百多个国家和地区的一千八百多名嘉宾将围绕领导力四点零全球化新时代的成功之道展开两百多场讨论。
住房和城乡建设部今天表示，截止5月底，各地上报需要改造的城镇老旧小区17万个，涉及居民上亿人。	住房和城乡建设部今天表示，截止五月底，各地上报需要改造的城镇老旧小区十七万个，涉及居民上亿人。
为期两个月的全国铁路暑运今天启动，预计发送旅客7.2亿人次，同比增长8.1%。	为期两个月的全国铁路暑运今天启动，预计发送旅客七点二亿人次，同比增长百分之八点一。
埋头苦干带领88户418名贫困群众脱贫，全村贫困发生率下降20%以上。	埋头苦干带领八十八户四百一十八名贫困群众脱贫，全村贫困发生率下降百分之二十以上。
我国第一条利用现有高铁富余运力开行的公交化列车，海口市交列车今天通车运营，运营线路全长38公里。	我国第一条利用现有高铁富余运力开行的公交化列车，海口市交列车今天通车运营，运营线路全长三十八公里。
设有海口站、美兰站等6个站点。市郊列车实现了海口航空铁路运输的无缝衔接，同时串联起海口主城区。	设有海口站、美兰站等六个站点。市郊列车实现了海口航空铁路运输的无缝衔接，同时串联起海口主城区。
2019年6月17号凌晨，他在从百色返回乐业途中遭遇山洪不幸遇难。	二零一九年六月十七号凌晨，他在从百色返回乐业途中遭遇山洪不幸遇难。
献出了年仅30岁的宝贵生命。	献出了年仅三十岁的宝贵生命。
卡尼号此次进入黑海，是准备参加乌克兰和美国海风2019联合军演。	卡尼号此次进入黑海，是准备参加乌克兰和美国海风二零一九联合军演。
11家出版单位出版的30种学习习近平新时代中国特色社会主义思想，重点数字图书。	十一家出版单位出版的三十种学习习近平新时代中国特色社会主义思想，重点数字图书。
7月1号在14家网络传播平台上线。	七月一号在十四家网络传播平台上线。
专栏上线的30种重点数字图书，包括习近平总书记著作讲话单行本。	专栏上线的三十种重点数字图书，包括习近平总书记著作讲话单行本。
俄罗斯防御管理中心6月30号发布消息称，美国卡尼号驱逐舰与日前驶入黑海海域。	俄罗斯防御管理中心六月三十号发布消息称，美国卡尼号驱逐舰与日前驶入黑海海域。
14家网络传播平台设置了新时代新经典，学习习近平新时代中国特色社会主义思想重点数字图书专栏。	十四家网络传播平台设置了新时代新经典，学习习近平新时代中国特色社会主义思想重点数字图书专栏。
今天是党的98岁生日，各地共产党员不忘初心，用奋斗书写新时代的新篇章。	今天是党的九十八岁生日，各地共产党员不忘初心，用奋斗书写新时代的新篇章。
2017年兰考脱贫摘帽，此后发展设施农业，实现乡村振兴，成了兰考的新目标。	二零一七年兰考脱贫摘帽，此后发展设施农业，实现乡村振兴，成了兰考的新目标。
黔西南州33万多人异地搬迁任务宣告完成。	黔西南州三十三万多人异地搬迁任务宣告完成。
7月1号，中共中央政治局常委国务院总理李克强在辽宁大连考察。	七月一号，中共中央政治局常委国务院总理李克强在辽宁大连考察。
香港举行升旗仪式，开展我爱香港主题活动，庆祝回归22周年。	香港举行升旗仪式，开展我爱香港主题活动，庆祝回归二十二周年。
国务院总理李克强7月1号下午在大连会见保加利亚总统拉德夫。	国务院总理李克强七月一号下午在大连会见保加利亚总统拉德夫。
李克强表示，今年适逢中保建交70周年，两国关系经得起国际风云变幻考验，始终保持健康稳定发展。	李克强表示，今年适逢中保建交七十周年，两国关系经得起国际风云变幻考验，始终保持健康稳定发展。
国务院总理李克强7月1号下午在大连会见格鲁吉亚总理巴赫塔泽。	国务院总理李克强七月一号下午在大连会见格鲁吉亚总理巴赫塔泽。
今天是6月1号，星期六农历4月28，欢迎收看新闻联播节目。	今天是六月一号，星期六农历四月二十八，欢迎收看新闻联播节目。
今年是新中国成立70周年，在这个时刻开展不忘初心，牢记使命主题教育。	今年是新中国成立七十周年，在这个时刻开展不忘初心，牢记使命主题教育。
本台消息，根据国务院关税税则委员会2019年第三号公告，中国已于2019年6月1号起。	本台消息，根据国务院关税税则委员会二零一九年第三号公告，中国已于二零一九年六月一号起。
分别实施加征25%、20%、10%的关税。	分别实施加征百分之二十五、百分之二十、百分之十的关税。
对之前加征5%关税的税目商品仍实施加征5%的关税。	对之前加征百分之五关税的税目商品仍实施加征百分之五的关税。
去年美国对华大豆出口减了一半，今年一季度美国对华农产品出口同比下降60%。	去年美国对华大豆出口减了一半，今年一季度美国对华农产品出口同比下降百分之六十。
国务院关税税则委员会对原产于美国约600亿美元进口商品清单中的部分商品。	国务院关税税则委员会对原产于美国约六百亿美元进口商品清单中的部分商品。
美国弗吉尼亚州发生枪击事件已造成12人遇害。接下来请您收看详细内容。	美国弗吉尼亚州发生枪击事件已造成十二人遇害。接下来请您收看详细内容。
预计到2020年大豆种植面积将达1.4亿亩，总产量增至1900万吨。	预计到二零二零年大豆种植面积将达一点四亿亩，总产量增至一千九百万吨。
大豆出口同比下降80%。	大豆出口同比下降百分之八十。
通过改进饲料配方，每年可减少大豆需求1400万吨。	通过改进饲料配方，每年可减少大豆需求一千四百万吨。
本台消息在六一国际儿童节来临之际，国家主席习近平5月31号给澳门濠江中学。	本台消息在六一国际儿童节来临之际，国家主席习近平五月三十一号给澳门濠江中学。
作为一家在中国运营数10年的快递公司，联邦快递有义务配合中国有关部门的调查。	作为一家在中国运营数十年的快递公司，联邦快递有义务配合中国有关部门的调查。
中国有关部门6月1号宣布，由于美国联邦快递在中国发生未按明指投递快件行为。	中国有关部门六月一号宣布，由于美国联邦快递在中国发生未按明指投递快件行为。
文章说，中国政府从6月1号开始对价值约600亿美元的美国商品提高关税。	文章说，中国政府从六月一号开始对价值约六百亿美元的美国商品提高关税。
本台消息，国务院新闻办公室将于明天10点发布关于中美经贸磋商的中方立场白皮书。	本台消息，国务院新闻办公室将于明天十点发布关于中美经贸磋商的中方立场白皮书。
本台消息，新华社6月1号播发，风雨不动，安如山。今日是中国系列述评之期。	本台消息，新华社六月一号播发，风雨不动，安如山。今日是中国系列述评之期。
回归祖国。20年来，澳门发展日新月异，澳门同胞工作生活越来越好。	回归祖国。二十年来，澳门发展日新月异，澳门同胞工作生活越来越好。
从5月9号开始，在西藏第二大湖纳木错开展7次高空观测，并创下最高7003米的新纪录。	从五月九号开始，在西藏第二大湖纳木错开展七次高空观测，并创下最高七千零三米的新纪录。
新加坡总理李显龙5月31号在第18届香格里拉对话会上表示。	新加坡总理李显龙五月三十一号在第十八届香格里拉对话会上表示。
针对美国政府日前宣布对墨西哥加征关税，墨西哥总统洛佩斯当地时间5月31号表示。	针对美国政府日前宣布对墨西哥加征关税，墨西哥总统洛佩斯当地时间五月三十一号表示。
美国总统特朗普5月31号宣布，美国政府将于6月5号正式取消给予印度的普惠制待遇。	美国总统特朗普五月三十一号宣布，美国政府将于六月五号正式取消给予印度的普惠制待遇。
巴勒斯坦外交部5月31号发表声明，谴责以色列军警当天开枪打死两名巴勒斯坦人。	巴勒斯坦外交部五月三十一号发表声明，谴责以色列军警当天开枪打死两名巴勒斯坦人。
濠江中学创建于1932年，以爱国爱澳为社会培育人才为办学宗旨。	濠江中学创建于一九三二年，以爱国爱澳为社会培育人才为办学宗旨。
是澳门中小学生人数最多的学校，该校素有爱国主义传统，1949年10月1日新中国刚刚成立。	是澳门中小学生人数最多的学校，该校素有爱国主义传统，一九四九年十月一日新中国刚刚成立。
本台消息6月1号出版的第11期求是杂志，发表中共中央总书记国家主席。	本台消息六月一号出版的第十一期求是杂志，发表中共中央总书记国家主席。
习近平向第14届伊斯兰合作组织首脑会议致贺电。	习近平向第十四届伊斯兰合作组织首脑会议致贺电。
成立50年来，为促进伊斯兰国家合作作出重要贡献，我对此表示高度赞赏。习近平强调。	成立五十年来，为促进伊斯兰国家合作作出重要贡献，我对此表示高度赞赏。习近平强调。
总书记指出的4个迫切需要，深刻阐明了开展主题教育的重大意义。	总书记指出的四个迫切需要，深刻阐明了开展主题教育的重大意义。
中国对美部分进口商品加征关税于6月1号正式实施。	中国对美部分进口商品加征关税于六月一号正式实施。
第7届军运会在南昌采集火种并启动火炬传递。	第七届军运会在南昌采集火种并启动火炬传递。
而在这接近20万亿消费行为的贡献里，服务消费的占比又达到了49.4%。	而在这接近二十万亿消费行为的贡献里，服务消费的占比又达到了百分之四十九点四。
这8年，农村居民人均消费支出名义增速比城镇居民还跑快了2.3个百分点。	这八年，农村居民人均消费支出名义增速比城镇居民还跑快了二点三个百分点。
国家邮政局数据显示，上半年农村快递增速比城市高近10个百分点。	国家邮政局数据显示，上半年农村快递增速比城市高近十个百分点。
我们现在是人均GDP在1万美金左右。	我们现在是人均GDP在一万美金左右。
数据显示，消费已连续5年成为拉动中国经济增长的第一动力。	数据显示，消费已连续五年成为拉动中国经济增长的第一动力。
今年第7号台风为怕在海南文昌沿海登陆，受台风影响，广东、广西、海南等地有大到暴雨。	今年第七号台风为怕在海南文昌沿海登陆，受台风影响，广东、广西、海南等地有大到暴雨。
快评说7月30号召开的中共中央政治局会议要求要紧紧围绕巩固增强。	快评说七月三十号召开的中共中央政治局会议要求要紧紧围绕巩固增强。
92年来，人民军队历经硝烟战火，一路披荆斩棘，取得一个个辉煌胜利。	九十二年来，人民军队历经硝烟战火，一路披荆斩棘，取得一个个辉煌胜利。
不忘初心，牢记使命主题教育部分中央指导组工作座谈会8月1号在京召开。	不忘初心，牢记使命主题教育部分中央指导组工作座谈会八月一号在京召开。
中央政治局第15次集体学习中央和国家机关党的建设工作会议。	中央政治局第十五次集体学习中央和国家机关党的建设工作会议。
内蒙古考察听取中央第三轮巡视综合情况汇报，中央全面深化改革委员会第9次会议的重要讲话精神。	内蒙古考察听取中央第三轮巡视综合情况汇报，中央全面深化改革委员会第九次会议的重要讲话精神。
全新的央视农业农村频道也于8月1日试验播出。	全新的央视农业农村频道也于八月一日试验播出。
今天是中国人民解放军建军92周年纪念日，第7届世界军人运动会在英雄城南昌采集火种并启动火炬传递。	今天是中国人民解放军建军九十二周年纪念日，第七届世界军人运动会在英雄城南昌采集火种并启动火炬传递。
中共中央总书记、国家主席中央军委主席习近平在庆祝建军90周年大会上指出。	中共中央总书记、国家主席中央军委主席习近平在庆祝建军九十周年大会上指出。
在经过全程约1千米共20磅的传递后，火炬传递启动仪式圆满结束。	在经过全程约一千米共二十磅的传递后，火炬传递启动仪式圆满结束。
第7届世界军人运动会将于2019年10月18日在中国武汉开幕。	第七届世界军人运动会将于二零一九年十月十八日在中国武汉开幕。
上午8:00火炬传递在八一广场启动，军运会火炬名称为和平荣光，象征着和平发展友谊。	上午八点火炬传递在八一广场启动，军运会火炬名称为和平荣光，象征着和平发展友谊。
1964年我国第一颗原子弹爆炸成功，向世界庄严宣告。	一九六四年我国第一颗原子弹爆炸成功，向世界庄严宣告。
这些废弃的厂房是我国最早的核武器研制基地221工厂。	这些废弃的厂房是我国最早的核武器研制基地两百二十一工厂。
1955年1月15号，中共中央书记处召开扩大会议。	一九五五年一月十五号，中共中央书记处召开扩大会议。
"当时有一种气概，25,000里长征我没赶上，可是这个我赶上了自然是非要做出来不可。"	当时有一种气概，二万五千里长征我没赶上，可是这个我赶上了自然是非要做出来不可。
1964年1月高农游235研制成功。5月1号，酒泉原子能联合企业加工出合格的原子弹部件。	一九六四年一月高农游两百三十五研制成功。五月一号，酒泉原子能联合企业加工出合格的原子弹部件。
6月6号，青海西北核武器研制基地成功进行了1:1模型爆轰试验。	六月六号，青海西北核武器研制基地成功进行了一:一模型爆轰试验。
1964年10月16号15:00，巨大的蘑菇云在新疆罗布泊荒漠腾空而起。	一九六四年十月十六号十五点，巨大的蘑菇云在新疆罗布泊荒漠腾空而起。
今天凌晨1:50前后，今年第7号台风为怕在海南文昌沿海登陆。	今天凌晨一:五十前后，今年第七号台风为怕在海南文昌沿海登陆。
登陆时强度为热带风暴级中心附近最大风力9级。	登陆时强度为热带风暴级中心附近最大风力九级。
98个乡镇区雨量超过100毫米，海口市市区最大降雨量达到342.2毫米。	九十八个乡镇区雨量超过一百毫米，海口市市区最大降雨量达到三百四十二点二毫米。
平山镇最深处水位达1.5米左右。	平山镇最深处水位达一点五米左右。
今天我国自主研制的大型客机，c919的第4架试飞飞机在上海浦东国际机场完成首次试验飞行。	今天我国自主研制的大型客机，c九一九的第四架试飞飞机在上海浦东国际机场完成首次试验飞行。
经过近24小时的紧张抢险，目前阿什河阿城区各段及支流的固低围堰及人员疏散等已完成。	经过近二十四小时的紧张抢险，目前阿什河阿城区各段及支流的固低围堰及人员疏散等已完成。
记者今天从工信部获悉，我国行政村光纤和4G网络通达比例均超过98%。	记者今天从工信部获悉，我国行政村光纤和四G网络通达比例均超过百分之九十八。
全国铁路暑运自7月1号启动以来，一个月累计发送旅客3.56亿人次，同比增长9.7%。	全国铁路暑运自七月一号启动以来，一个月累计发送旅客三点五六亿人次，同比增长百分之九点七。
中国东盟外长会7月31号在泰国曼谷举行。	中国东盟外长会七月三十一号在泰国曼谷举行。
7月份连续31天单日客流在1000万人次以上，其中高铁动车组列车客流量占比达到62.1%。	七月份连续三十一天单日客流在一千万人次以上，其中高铁动车组列车客流量占比达到百分之六十二点一。
2014年9月胡塞武装夺取也门首都萨，那2015年亚丁被也门政府定为临时首都。	二零一四年九月胡塞武装夺取也门首都萨，那二零一五年亚丁被也门政府定为临时首都。
联合国粮食及农业组织7月31号在意大利罗马举行总干事交接仪式。	联合国粮食及农业组织七月三十一号在意大利罗马举行总干事交接仪式。
伊朗外长扎里夫7月31号表示，美国对他实施的制裁对其本人及家人都没有任何影响。	伊朗外长扎里夫七月三十一号表示，美国对他实施的制裁对其本人及家人都没有任何影响。
这是自2008年12月以来，美联储首次降息符合市场预期。	这是自二零零八年十二月以来，美联储首次降息符合市场预期。
今天是8月1号星期四，农历7月初一。欢迎收看新闻联播节目。	今天是八月一号星期四，农历七月初一。欢迎收看新闻联播节目。
从那天开始我和战友们在野外一练就是10多个月。	从那天开始我和战友们在野外一练就是十多个月。
2019年上半年中国元首外交纪实。	二零一九年上半年中国元首外交纪实。
上半年消费对经济的贡献率达到60.1%，释放出有力的拉动作用。	上半年消费对经济的贡献率达到百分之六十点一，释放出有力的拉动作用。
消费的潜力在哪里？夜幕降临，北京市推出夜间经济13条。	消费的潜力在哪里？夜幕降临，北京市推出夜间经济十三条。
"数据显示上半年社会消费品零售总额达195,210亿元，同比名义增长8.4%。"	数据显示上半年社会消费品零售总额达十九万五千两百一十亿元，同比名义增长百分之八点四。
为实现两个100年奋斗目标，实现中华民族伟大复兴的中国梦作出应有贡献。	为实现两个一百年奋斗目标，实现中华民族伟大复兴的中国梦作出应有贡献。
2019年春季学期，中央党校国家行政学院中青年干部培训班学员参加开班式。	二零一九年春季学期，中央党校国家行政学院中青年干部培训班学员参加开班式。
2013年到2018年全国两会期间。	二零一三年到二零一八年全国两会期间。
6年来，全军部队认真贯彻习主席重要讲话精神，牢固确立习近平强军思想的指导地位。	六年来，全军部队认真贯彻习主席重要讲话精神，牢固确立习近平强军思想的指导地位。
2013年3月11日，习主席在出席十二届全国人大一次会议，解放军代表团全体会议时鲜明提出。	二零一三年三月十一日，习主席在出席十二届全国人大一次会议，解放军代表团全体会议时鲜明提出。
2019年春季学期，中央党校国家行政学院中青年干部培训班，一号上午在中央党校开班。	二零一九年春季学期，中央党校国家行政学院中青年干部培训班，一号上午在中央党校开班。
2014年金秋在习主席亲自决策和领导下，人民军队重回古田召开全军政治工作会议。	二零一四年金秋在习主席亲自决策和领导下，人民军队重回古田召开全军政治工作会议。
2015年全国两会上习主席宣布，把军民融合发展上升为国家战略。	二零一五年全国两会上习主席宣布，把军民融合发展上升为国家战略。
政协第十三届全国委员会常务委员会第5次会议。	政协第十三届全国委员会常务委员会第五次会议。
研究部署2019年重点工作和重大政策举措。	研究部署二零一九年重点工作和重大政策举措。
来自国家航天局的消息，嫦娥4号着陆器已于今天上午7:52自主唤醒，按计划开始第3月昼后续工作。	来自国家航天局的消息，嫦娥四号着陆器已于今天上午七点五十二自主唤醒，按计划开始第三月昼后续工作。
此前玉兔二号月球车已于2月28号自主唤醒，目前行走正常。	此前玉兔二号月球车已于二月二十八号自主唤醒，目前行走正常。
为期40天的春运今天落幕，全国累计发送旅客近30亿人次，和去年基本持平。	为期四十天的春运今天落幕，全国累计发送旅客近三十亿人次，和去年基本持平。
据了解，去年8月非洲猪瘟疫情发生以来，公安部会同有关部门严打违法犯罪活动。	据了解，去年八月非洲猪瘟疫情发生以来，公安部会同有关部门严打违法犯罪活动。
截至目前各地破获涉非洲猪瘟刑事案件32起，查明涉案生猪1.5万多头。	截至目前各地破获涉非洲猪瘟刑事案件三十二起，查明涉案生猪一点五万多头。
2月28号美国著名的指数编制公司名胜宣布。	二月二十八号美国著名的指数编制公司名胜宣布。
其中铁路发送旅客4.1亿人次，增长7.4%，民航发送旅客7300万人次，增长12%。	其中铁路发送旅客四点一亿人次，增长百分之七点四，民航发送旅客七千三百万人次，增长百分之十二。
通过三步把中国A股纳入因子，从5%增加至20%。	通过三步把中国A股纳入因子，从百分之五增加至百分之二十。
巴基斯坦总理伊姆兰汉2月28号宣布为缓和同印度关系紧张状态。	巴基斯坦总理伊姆兰汉二月二十八号宣布为缓和同印度关系紧张状态。
我们党在中国这样一个有着近14亿人口的大国执政。	我们党在中国这样一个有着近十四亿人口的大国执政。
新中国成立70周年，是进行不忘初心，牢记使命教育的最好时间节点。	新中国成立七十周年，是进行不忘初心，牢记使命教育的最好时间节点。
全国政协十三届常委会第5次会议闭幕，汪洋主持并讲话。	全国政协十三届常委会第五次会议闭幕，汪洋主持并讲话。
今天是7月15号，星期一，农历6月13，欢迎收看新闻联播节目。	今天是七月十五号，星期一，农历六月十三，欢迎收看新闻联播节目。
总体平稳。6月份全国城镇调查失业率为5.1%，稳定在5%左右的水平。	总体平稳。六月份全国城镇调查失业率为百分之五点一，稳定在百分之五左右的水平。
从收入看，上半年全国居民人均可支配收入实际增长6.5%。	从收入看，上半年全国居民人均可支配收入实际增长百分之六点五。
1~6月份我国居民消费价格CPI延续了温和上涨的态势，工业生产者价格基本平稳。	一到六月份我国居民消费价格CPI延续了温和上涨的态势，工业生产者价格基本平稳。
上半年消费增长对经济增长的贡献率超过了60%。	上半年消费增长对经济增长的贡献率超过了百分之六十。
与此同时上半年社会领域高技术产业等投资都保持在10%以上，投资结构优化趋势明显。	与此同时上半年社会领域高技术产业等投资都保持在百分之十以上，投资结构优化趋势明显。
区域结构在优化。上半年中部地区规模以上工业增加值同比增长8.4%。	区域结构在优化。上半年中部地区规模以上工业增加值同比增长百分之八点四。
本台消息7月16号出版的第14期求是杂志。	本台消息七月十六号出版的第十四期求是杂志。
看经济结构，产业结构在优化，工业转型升级加快推进，上半年高技术制造业增加值同比增长9%。	看经济结构，产业结构在优化，工业转型升级加快推进，上半年高技术制造业增加值同比增长百分之九。
从上个世纪60年代组建至今，内蒙古大兴安岭森林消防支队其前中队的一代代消防队员们。	从上个世纪六十年代组建至今，内蒙古大兴安岭森林消防支队其前中队的一代代消防队员们。
1987年5月，大兴安岭地区发生新中国成立以来最严重的一次特大火灾。	一九八七年五月，大兴安岭地区发生新中国成立以来最严重的一次特大火灾。
2017年4月30号，边境大火突袭大兴安岭伊木河林场。	二零一七年四月三十号，边境大火突袭大兴安岭伊木河林场。
到2030年居民主要健康指标水平进入高收入国家行列，健康公平基本实现。	到二零三零年居民主要健康指标水平进入高收入国家行列，健康公平基本实现。
在荒无人烟的林海孤岛中默默坚守了57年。	在荒无人烟的林海孤岛中默默坚守了五十七年。
新中国成立之初一穷二白，70年来在中国共产党的领导下。	新中国成立之初一穷二白，七十年来在中国共产党的领导下。
为了填补大西南的铁路空白，1950年6月新生的共和国开始修建成渝铁路。	为了填补大西南的铁路空白，一九五零年六月新生的共和国开始修建成渝铁路。
当时17岁的西南军区军工筑路第一总队参谋孙姨孙参加了成渝铁路修建的全过程。	当时十七岁的西南军区军工筑路第一总队参谋孙姨孙参加了成渝铁路修建的全过程。
350米的头像大小钢梁就这么加起来了。	三百五十米的头像大小钢梁就这么加起来了。
在成渝铁路完工后的67年里，广袤的中华大地上纵横交错的铁路网在不断延展。	在成渝铁路完工后的六十七年里，广袤的中华大地上纵横交错的铁路网在不断延展。
2017年具有完全自主知识产权的中国标准动车组复兴号投入运营，标志着我国高铁技术装备开始领跑世界。	二零一七年具有完全自主知识产权的中国标准动车组复兴号投入运营，标志着我国高铁技术装备开始领跑世界。
2006年青藏铁路的开通成为世界屋脊发展的引擎，进入新时代交通强国，铁路先行。	二零零六年青藏铁路的开通成为世界屋脊发展的引擎，进入新时代交通强国，铁路先行。
1975年第一条电气化铁路，宝成铁路建成结束了蜀道难难于上青天的历史。	一九七五年第一条电气化铁路，宝成铁路建成结束了蜀道难难于上青天的历史。
经过3万多解放军和10万民工艰苦卓绝的奋斗，1952年6月13号成渝铁路竣工。	经过三万多解放军和十万民工艰苦卓绝的奋斗，一九五二年六月十三号成渝铁路竣工。
对新中国70年发生了怎样的变化？中国经济奇迹是如何创造的？	对新中国七十年发生了怎样的变化？中国经济奇迹是如何创造的？
中国道路为什么好，中国共产党为什么能等12个重大问题作出了深入浅出的解读阐释。	中国道路为什么好，中国共产党为什么能等十二个重大问题作出了深入浅出的解读阐释。
有助于广大干部群众深入理解新中国70年来的伟大历程，辉煌成就和宝贵经验。	有助于广大干部群众深入理解新中国七十年来的伟大历程，辉煌成就和宝贵经验。
今天是第5个世界青年技能日，人社部等6部门以技能扶贫为主题，开展了技能扶贫政策的全面宣传。	今天是第五个世界青年技能日，人社部等六部门以技能扶贫为主题，开展了技能扶贫政策的全面宣传。
部分地区甚至超过300毫米。水利部监测显示，入汛以来，全国377条河流发生超警以上洪水。	部分地区甚至超过三百毫米。水利部监测显示，入汛以来，全国三百七十七条河流发生超警以上洪水。
14号法国、英国和德国三国领导人发表联合声明，呼吁美国、伊朗等各方恢复对话。	十四号法国、英国和德国三国领导人发表联合声明，呼吁美国、伊朗等各方恢复对话。
据了解，2018年全国开展贫困劳动力培训200万人次，技工院校招收建档立卡贫困家庭子女6.42万人。	据了解，二零一八年全国开展贫困劳动力培训两百万人次，技工院校招收建档立卡贫困家庭子女六点四二万人。
按计划欧盟各国外长将于当地时间15号在布鲁塞尔举行会议，讨论伊朗核问题。	按计划欧盟各国外长将于当地时间十五号在布鲁塞尔举行会议，讨论伊朗核问题。
跳水女双10米台决赛，中国组合芦苇张佳琪夺得冠军。	跳水女双十米台决赛，中国组合芦苇张佳琪夺得冠军。
伊朗外长扎里夫14号说，如果欧洲想维护伊核协议，就应该履行承诺在伊朗进行投资。	伊朗外长扎里夫十四号说，如果欧洲想维护伊核协议，就应该履行承诺在伊朗进行投资。
2015年签署的伊核协议面临着失败风险，所有利益相关方都有必要停下来考虑自身行动可能产生的后果。	二零一五年签署的伊核协议面临着失败风险，所有利益相关方都有必要停下来考虑自身行动可能产生的后果。
俄军近几天派遣多架运输机向土耳其空运土方购买的s400防空导弹系统。	俄军近几天派遣多架运输机向土耳其空运土方购买的s四百防空导弹系统。
欧盟主导的伽利略卫星导航系统预定于2020年实现全部卫星组网。	欧盟主导的伽利略卫星导航系统预定于二零二零年实现全部卫星组网。
我们所要坚守的政治方向就是共产主义远大理想和中国特色社会主义共同理想，两个100年奋斗目标。	我们所要坚守的政治方向就是共产主义远大理想和中国特色社会主义共同理想，两个一百年奋斗目标。
在中央政治局第15次集体学习时的重要讲话结合起来。	在中央政治局第十五次集体学习时的重要讲话结合起来。
上半年我国国内生产总值同比增长6.3%，经济运行继续保持在合理区间。	上半年我国国内生产总值同比增长百分之六点三，经济运行继续保持在合理区间。
通知指出，2010年10月中共中央办公厅国务院办公厅印发的。	通知指出，二零一零年十月中共中央办公厅国务院办公厅印发的。
今年是新中国成立70周年，新闻联播推出系列报道新中国的第一，记录新中国砥砺前行的奋斗历程。	今年是新中国成立七十周年，新闻联播推出系列报道新中国的第一，记录新中国砥砺前行的奋斗历程。
本规定自2019年7月7号起施行。2010年10月12号中共中央办公厅国务院办公厅印发的。	本规定自二零一九年七月七号起施行。二零一零年十月十二号中共中央办公厅国务院办公厅印发的。
"初步核算上半年国内生产总值450,933亿元，按可比价格计算同比增长6.3%。"	初步核算上半年国内生产总值四十五万九百三十三亿元，按可比价格计算同比增长百分之六点三。
6.3%是一个含金量比较高的速度。我们看到就业的情况还比较稳定。	百分之六点三是一个含金量比较高的速度。我们看到就业的情况还比较稳定。
看三大民生指标，从就业看，上半年全国城镇新增就业完成全年目标任务的67%。	看三大民生指标，从就业看，上半年全国城镇新增就业完成全年目标任务的百分之六十七。
意见指出，党中央国务院高度重视养老服务，按照2019年政府工作报告对养老服务工作的部署。	意见指出，党中央国务院高度重视养老服务，按照二零一九年政府工作报告对养老服务工作的部署。
确保到2022年在保障人人享有基本养老服务的基础上。	确保到二零二二年在保障人人享有基本养老服务的基础上。
意见提出了6个方面，共28条具体政策措施。一是深化放管服改革。	意见提出了六个方面，共二十八条具体政策措施。一是深化放管服改革。
主要包括建立养老服务综合监管制度等7项措施。二是拓展养老服务投融资渠道。	主要包括建立养老服务综合监管制度等七项措施。二是拓展养老服务投融资渠道。
主要包括建立健全长期照护服务体系等4项措施。	主要包括建立健全长期照护服务体系等四项措施。
五是促进养老服务高质量发展，主要包括提升医养，结合服务能力等6项措施。	五是促进养老服务高质量发展，主要包括提升医养，结合服务能力等六项措施。
虽然距离2019年中国国际进口博览会还有半年多，但目前已有1800多家企业报名参展。	虽然距离二零一九年中国国际进口博览会还有半年多，但目前已有一千八百多家企业报名参展。
主要包括实施特困人员供养、服务设施、敬老院改造提升工程等5项措施。	主要包括实施特困人员供养、服务设施、敬老院改造提升工程等五项措施。
2018年举办的首届进博会被打造成面向全球的开放型合作平台。	二零一八年举办的首届进博会被打造成面向全球的开放型合作平台。
这一年中国扩大进口额接近2万亿美元，在主动开放市场的同时。	这一年中国扩大进口额接近二万亿美元，在主动开放市场的同时。
中国也正在积极参与国际规则的制定。2018年中国出台扩大金融开放的11条措施。	中国也正在积极参与国际规则的制定。二零一八年中国出台扩大金融开放的十一条措施。
其中已签约企业数量超过900家，分别来自77个国家和地区。	其中已签约企业数量超过九百家，分别来自七十七个国家和地区。
公布最新版外商投资负面清单，清单长度由63条减至48条，中国4次降低关税。	公布最新版外商投资负面清单，清单长度由六十三条减至四十八条，中国四次降低关税。
一带一路倡议提出近6年来从主动开放市场参与规则制定到深度融入世界。	一带一路倡议提出近六年来从主动开放市场参与规则制定到深度融入世界。
其中有30多个共建一带一路国家。	其中有三十多个共建一带一路国家。
关税总水平从上一年的9.8%降至7.5%，全年新增外资企业6.9万家。	关税总水平从上一年的百分之九点八降至百分之七点五，全年新增外资企业六点九万家。
本台消息，国家主席习近平4月16号就法国巴黎圣母院发生火灾。	本台消息，国家主席习近平四月十六号就法国巴黎圣母院发生火灾。
与法国、德国、日本、新加坡等20多个发达国家和新兴经济体开展第三方市场合作。	与法国、德国、日本、新加坡等二十多个发达国家和新兴经济体开展第三方市场合作。
今年一季度，中国与共建一带一路国家外贸进出口总额达到2万亿美元，同比增长7.8%。	今年一季度，中国与共建一带一路国家外贸进出口总额达到二万亿美元，同比增长百分之七点八。
一大一路倡议提出近6年来，在全球贸易持续低迷的背景下。	一大一路倡议提出近六年来，在全球贸易持续低迷的背景下。
目前中国已与40多个共建一带一路国家建立了双边产能与投资合作机制。	目前中国已与四十多个共建一带一路国家建立了双边产能与投资合作机制。
一季度累计实现营业收入6.8万亿元，同比增长6.3%，有23家企业收入增幅超过20%。	一季度累计实现营业收入六点八万亿元，同比增长百分之六点三，有二十三家企业收入增幅超过百分之二十。
中国与共建一带一路国家货物贸易总额超过6万亿美元，呈持续增长态势。	中国与共建一带一路国家货物贸易总额超过六万亿美元，呈持续增长态势。
48家企业收入增幅超过11%季度央企累计实现利润总额4265亿元。	四十八家企业收入增幅超过百分之十一季度央企累计实现利润总额四千两百六十五亿元。
同比增长13.1%，有36家企业利润总额增幅超过20%。	同比增长百分之十三点一，有三十六家企业利润总额增幅超过百分之二十。
财政部最新数据显示，今年一季度全国一般公共预算收入和支出均超过5万亿元。	财政部最新数据显示，今年一季度全国一般公共预算收入和支出均超过五万亿元。
收入和支出同比分别增长6.2%和15%，其中税收收入增速明显放缓，同比增长5.4%。	收入和支出同比分别增长百分之六点二和百分之十五，其中税收收入增速明显放缓，同比增长百分之五点四。
回落了11.9个百分点。	回落了十一点九个百分点。
国内增值税同比增长10.7%，同比回落9.4个百分点。	国内增值税同比增长百分之十点七，同比回落九点四个百分点。
个人所得税同比下降29.7%，回落50.4个百分点。	个人所得税同比下降百分之二十九点七，回落五十点四个百分点。
目前11个试点城市均已实施药品集中采购和使用。	目前十一个试点城市均已实施药品集中采购和使用。
25个中选品种采购总金额为5.33亿元，约定采购量完成进度达27.31%。	二十五个中选品种采购总金额为五点三三亿元，约定采购量完成进度达百分之二十七点三一。
组成联盟，开展药品采购，集合11个城市公立医院的用量，实现量价挂钩，以量换价。	组成联盟，开展药品采购，集合十一个城市公立医院的用量，实现量价挂钩，以量换价。
已中选的乙肝抗病毒、仿制药、nt卡为分散片为例，价格由中选前的每盒248元下降到17.36元。	已中选的乙肝抗病毒、仿制药、nt卡为分散片为例，价格由中选前的每盒两百四十八元下降到十七点三六元。
河南郑州利用拆违拆旧，打造7000里绿道。	河南郑州利用拆违拆旧，打造七千里绿道。
很多人想象不到，就在两个多月前，这里还集中了60多家小散乱污企业，多个废品收购站。	很多人想象不到，就在两个多月前，这里还集中了六十多家小散乱污企业，多个废品收购站。
而在城区主干道中原西路两侧违建拆除后，腾出的土地也建成了两条50~120米宽的绿道。	而在城区主干道中原西路两侧违建拆除后，腾出的土地也建成了两条五十到一百二十米宽的绿道。
2012年开始，郑州依托绿道建设打造城区生态廊道，串联起公园绿地。	二零一二年开始，郑州依托绿道建设打造城区生态廊道，串联起公园绿地。
郑州生态廊道的植物品种应用已经达到了1000多种。	郑州生态廊道的植物品种应用已经达到了一千多种。
据鸟类动物学会统计，近几年郑州鸟类已经增加了20多种。	据鸟类动物学会统计，近几年郑州鸟类已经增加了二十多种。
串联起了市区146个公园和近2万公顷绿地。	串联起了市区一百四十六个公园和近二万公顷绿地。
目前郑州市绿道还有190个断点。	目前郑州市绿道还有一百九十个断点。
出生于1902年的贺光，20岁考入北洋军阀举办的洛阳讲武堂学习军事。	出生于一九零二年的贺光，二十岁考入北洋军阀举办的洛阳讲武堂学习军事。
这让国民党反动派惊恐不已。8月11号，带贺光前去改编诈降的国民党敌军时。	这让国民党反动派惊恐不已。八月十一号，带贺光前去改编诈降的国民党敌军时。
如今贺光家乡的人们正在按照2020年坚决打赢脱贫攻坚战的要求。	如今贺光家乡的人们正在按照二零二零年坚决打赢脱贫攻坚战的要求。
农业农村部今天发布2018年海峡两岸农产品贸易额已增至37.73亿美元。	农业农村部今天发布二零一八年海峡两岸农产品贸易额已增至三十七点七三亿美元。
相比2012年增长幅度超过60%。目前全国14个省区市共建立了29个。	相比二零一二年增长幅度超过百分之六十。目前全国十四个省区市共建立了二十九个。
早鹤腔实弹的晚底包围，他临危不惧与敌人英勇搏斗，牺牲时年仅29岁。	早鹤腔实弹的晚底包围，他临危不惧与敌人英勇搏斗，牺牲时年仅二十九岁。
国家统计局今天发布房价数据显示，3月份一二三线城市新建商品住宅销售价格。	国家统计局今天发布房价数据显示，三月份一二三线城市新建商品住宅销售价格。
同比涨幅微升，涨幅分别比上月扩大0.1个百分点，0.2个百分点和0.3个百分点。	同比涨幅微升，涨幅分别比上月扩大零点一个百分点，零点二个百分点和零点三个百分点。
今天发布的第16次全国国民阅读调查结果显示二，018年。	今天发布的第十六次全国国民阅读调查结果显示二，零一十八年。
以网络手机和电子阅读器等媒介为主要形式的数字化阅读接触率为76.2%。	以网络手机和电子阅读器等媒介为主要形式的数字化阅读接触率为百分之七十六点二。
比2017年上升了3.2个百分点。	比二零一七年上升了三点二个百分点。
俄罗斯外交部副部长格鲁什科15号向媒体表示。	俄罗斯外交部副部长格鲁什科十五号向媒体表示。
将来自100多个国家和地区的驻华使节代表，展示天津的文化底蕴与新时代发展机遇。	将来自一百多个国家和地区的驻华使节代表，展示天津的文化底蕴与新时代发展机遇。
较2017年的80.3%有所提升。	较二零一七年的百分之八十点三有所提升。
俄罗斯外交部副部长格鲁什科15号说。	俄罗斯外交部副部长格鲁什科十五号说。
我国成年国民的综合阅读率为80.8%。	我国成年国民的综合阅读率为百分之八十点八。
2018年北约军舰在黑海水域的累计逗留时间，由此前的每年最多80天增至120天。	二零一八年北约军舰在黑海水域的累计逗留时间，由此前的每年最多八十天增至一百二十天。
2011年福岛核事故中，1号到三号机组严重受损，但由于工作难度大，准备过程复杂。	二零一一年福岛核事故中，一号到三号机组严重受损，但由于工作难度大，准备过程复杂。
和燃料棒取出工作比原计划晚了4年多。	和燃料棒取出工作比原计划晚了四年多。
今天是4月16号，星期二，农历3月12，欢迎收看新闻联播节目。	今天是四月十六号，星期二，农历三月十二，欢迎收看新闻联播节目。
日本东京电力公司15号开始取出福岛第一核电站事故机组中的核燃料棒。	日本东京电力公司十五号开始取出福岛第一核电站事故机组中的核燃料棒。
有媒体称修复费用预计需要1亿5000万欧元。	有媒体称修复费用预计需要一亿五千万欧元。
巴黎圣母院为哥特式建筑是建于1163年1345年完工。	巴黎圣母院为哥特式建筑是建于一一六三年一三四五年完工。
每年吸引游客大约1300万人次。	每年吸引游客大约一千三百万人次。
今年以来作为宏观调控的重要手段，财政政策加力提效，全年减税降费规模近2万亿元。	今年以来作为宏观调控的重要手段，财政政策加力提效，全年减税降费规模近二万亿元。
宏观政策有效释放稳定了市场稳定了预期。今年3月。	宏观政策有效释放稳定了市场稳定了预期。今年三月。
全国居民消费价格指数CPI同比上涨2.3%。	全国居民消费价格指数CPI同比上涨百分之二点三。
增幅0.4%，实现9个月以来的首次上扬。生产环节信心的恢复。	增幅百分之零点四，实现九个月以来的首次上扬。生产环节信心的恢复。
最新的中国制造业采购经理指数pmi在3月跨过了50%的临界点。	最新的中国制造业采购经理指数pmi在三月跨过了百分之五十的临界点。
重返扩张区间回升1.3个百分点，反弹至50.5%，走出6个月里的新高。	重返扩张区间回升一点三个百分点，反弹至百分之五十点五，走出六个月里的新高。
从2018年底布局来年经济大势的中央经济工作会议。	从二零一八年底布局来年经济大势的中央经济工作会议。
到初春时节，中共中央政治局第13次集体学习，中央定调高质量发展的长远决策。	到初春时节，中共中央政治局第十三次集体学习，中央定调高质量发展的长远决策。
将2019年全球经济增长预期下调至3.3%。	将二零一九年全球经济增长预期下调至百分之三点三。
同时将对中国经济增长的预期上调0.1个百分点至6.3%。	同时将对中国经济增长的预期上调零点一个百分点至百分之六点三。
全国人大常委会委员长栗战书16号在人民大会堂会见德国联邦议院副议长弗里德里希。	全国人大常委会委员长栗战书十六号在人民大会堂会见德国联邦议院副议长弗里德里希。
他强调陕西要按照习近平总书记5个扎实要求，认真落实好党中央国务院决策部署。	他强调陕西要按照习近平总书记五个扎实要求，认真落实好党中央国务院决策部署。
4月14号至16号，中共中央政治局常委国务院副总理韩正在陕西调研。	四月十四号至十六号，中共中央政治局常委国务院副总理韩正在陕西调研。
距离老队长王进喜在大庆油田打出第一口油井，已经整整59年了。	距离老队长王进喜在大庆油田打出第一口油井，已经整整五十九年了。
面对困难，王进喜带领1205钻井队应试平整人拉肩扛杠翘手台。	面对困难，王进喜带领一二零五钻井队应试平整人拉肩扛杠翘手台。
一天一夜端水50多吨，打井时突发井喷，为了避免井毁人亡。	一天一夜端水五十多吨，打井时突发井喷，为了避免井毁人亡。
爱国情奋斗者系列报道，今天播出铁人精神传承60载，我为祖国奋斗加油。	爱国情奋斗者系列报道，今天播出铁人精神传承六十载，我为祖国奋斗加油。
今年已经82岁的王启民被誉为第二代大庆新铁人。	今年已经八十二岁的王启民被誉为第二代大庆新铁人。
要发展就要拓展更广阔的天地。在一带一路重要国家，伊拉克来自大庆油田的海外1205钻井队。	要发展就要拓展更广阔的天地。在一带一路重要国家，伊拉克来自大庆油田的海外一二零五钻井队。
目前大庆油田的海外市场已经遍布全球35个国家和地区，2018年实现营收人民币突破百亿元。	目前大庆油田的海外市场已经遍布全球三十五个国家和地区，二零一八年实现营收人民币突破百亿元。
2005年曹燕生进入航天科工二院283厂，原以为能够接触到先进的数控加工设备。	二零零五年曹燕生进入航天科工二院两百八十三厂，原以为能够接触到先进的数控加工设备。
假期第一天踏青赏花也是热门选择。湖北麻城归封山10万多亩杜鹃花连片开放，江苏大丰。	假期第一天踏青赏花也是热门选择。湖北麻城归封山十万多亩杜鹃花连片开放，江苏大丰。
0.005左右，相当于头发丝的1/16，这应该是目前这个加工的应该是算是极致了。	零点零零五左右，相当于头发丝的十六分之一，这应该是目前这个加工的应该是算是极致了。
本台消息，今天出版的第9期求是杂志，发表中共中央总书记、国家主席、中央军委主席习近平的重要文章。	本台消息，今天出版的第九期求是杂志，发表中共中央总书记、国家主席、中央军委主席习近平的重要文章。
荷兰花海游人如织，3000万株郁金香吸引来上万游客。	荷兰花海游人如织，三千万株郁金香吸引来上万游客。
屋盖面积达18万平方米，顶部设有大面积天窗，保证自然光充足，预计北京大兴国际机场。	屋盖面积达十八万平方米，顶部设有大面积天窗，保证自然光充足，预计北京大兴国际机场。
将在今年6月30号前全部竣工验收，9月底前通航。	将在今年六月三十号前全部竣工验收，九月底前通航。
4月29号首次淮河生态经济带省际联席会在江苏淮安召开，沿淮5省29个市县共同发布。	四月二十九号首次淮河生态经济带省际联席会在江苏淮安召开，沿淮五省二十九个市县共同发布。
在今年8月16号12:00之前，捕捞渔船为捕捞渔船配套服务的捕捞辅助船等都不得出海作业。	在今年八月十六号十二点之前，捕捞渔船为捕捞渔船配套服务的捕捞辅助船等都不得出海作业。
心手相连，点亮生命健康扶贫大型公益活动。4月18号到4月30号在云南开展。	心手相连，点亮生命健康扶贫大型公益活动。四月十八号到四月三十号在云南开展。
日本第126代天皇德仁的即位仪式今天上午在东京举行。	日本第一百二十六代天皇德仁的即位仪式今天上午在东京举行。
委内瑞拉总统马杜罗当地时间4月30号晚上发表电视讲话说。	委内瑞拉总统马杜罗当地时间四月三十号晚上发表电视讲话说。
今天是5月1号星期三，农历3月27，欢迎收看新闻联播节目。	今天是五月一号星期三，农历三月二十七，欢迎收看新闻联播节目。
文章指出，中华文明经历了5000多年的历史变迁，但始终一脉相承。	文章指出，中华文明经历了五千多年的历史变迁，但始终一脉相承。
本台消息国家主席习近平5月1号同多米尼加总统梅迪纳互之贺电，庆祝两国建交一周年。	本台消息国家主席习近平五月一号同多米尼加总统梅迪纳互之贺电，庆祝两国建交一周年。
去年11月你成功对中国进行国事访问，我们共同规划两国关系发展蓝图达成很多重要共识。	去年十一月你成功对中国进行国事访问，我们共同规划两国关系发展蓝图达成很多重要共识。
习近平在贺电中指出，去年5月中国同多米尼加正式建立外交关系，揭开了两国关系新篇章。	习近平在贺电中指出，去年五月中国同多米尼加正式建立外交关系，揭开了两国关系新篇章。
本台消息，5月1号，国家主席习近平致电日本新天皇德人对其即位表示祝贺。	本台消息，五月一号，国家主席习近平致电日本新天皇德人对其即位表示祝贺。
习近平总书记在纪念五四运动100周年大会上的重要讲话，在各地引发热烈反响。	习近平总书记在纪念五四运动一百周年大会上的重要讲话，在各地引发热烈反响。
论学习贯彻习近平总书记在纪念五四运动100周年大会上重要讲话。	论学习贯彻习近平总书记在纪念五四运动一百周年大会上重要讲话。
文章指出，在2019年中国北京世界园艺博览会开幕式上的重要讲话中，习近平主席洞察人类文明发展规律。	文章指出，在二零一九年中国北京世界园艺博览会开幕式上的重要讲话中，习近平主席洞察人类文明发展规律。
把握顺应自然保护生态的发展大势，明确提出了同住生态文明之基，同走绿色发展之路的5点主张。	把握顺应自然保护生态的发展大势，明确提出了同住生态文明之基，同走绿色发展之路的五点主张。
人民创造历史，劳动开创未来。今年是新中国成立70周年，也是大庆油田发现60周年。	人民创造历史，劳动开创未来。今年是新中国成立七十周年，也是大庆油田发现六十周年。
从波兰壮阔的石油大会战到原有5000万吨以上，连续27年高产稳产。	从波兰壮阔的石油大会战到原有五千万吨以上，连续二十七年高产稳产。
钻透了300多座珠穆朗玛峰。	钻透了三百多座珠穆朗玛峰。
从抢滩国际市场，再到建设百年新油田，60年来，一代又一代的大庆石油人接续传承铁人精神。	从抢滩国际市场，再到建设百年新油田，六十年来，一代又一代的大庆石油人接续传承铁人精神。
实现我们05队队史上总进尺的300万米，很多人可能不理解这个数字，但是300万米就相当于。	实现我们零五队队史上总进尺的三百万米，很多人可能不理解这个数字，但是三百万米就相当于。
促进文化事业健康发展。从2013年至2018年，全国国有文艺院团财政补贴。	促进文化事业健康发展。从二零一三年至二零一八年，全国国有文艺院团财政补贴。
由101亿元增加到154亿元，年均增长近9%。国家艺术基金自2014年成立以来。	由一百零一亿元增加到一百五十四亿元，年均增长近百分之九。国家艺术基金自二零一四年成立以来。
共确立资助项目5112项，资助资金总额约41.1亿元，极大激发了各类文艺创作创新争优的积极性。	共确立资助项目五一一二项，资助资金总额约四十一点一亿元，极大激发了各类文艺创作创新争优的积极性。
以壮阔恢弘的丹青画卷向新中国70华诞献礼。2019年夏天，全国基层院团戏曲汇演在京上演。	以壮阔恢弘的丹青画卷向新中国七十华诞献礼。二零一九年夏天，全国基层院团戏曲汇演在京上演。
创作无愧于时代的优秀作品，将伟大历史征程记载于壮丽画卷。庆祝中华人民共和国成立70周年美术作品展。	创作无愧于时代的优秀作品，将伟大历史征程记载于壮丽画卷。庆祝中华人民共和国成立七十周年美术作品展。
必由之路等73部作品从不同角度讲述了精彩纷呈的中国故事，描绘出新时代的精神图谱。	必由之路等七十三部作品从不同角度讲述了精彩纷呈的中国故事，描绘出新时代的精神图谱。
对申请设立外资保险公司的外国保险公司，取消经营保险业务30年以上。	对申请设立外资保险公司的外国保险公司，取消经营保险业务三十年以上。
第7届世界军人运动会将于10月18号至27号在武汉举行，将有来自100多个国家的近万名军人同台竞技。	第七届世界军人运动会将于十月十八号至二十七号在武汉举行，将有来自一百多个国家的近万名军人同台竞技。
今天60多个国家的运动员入驻军运村，中国代表团参赛队员也已经准备就绪。	今天六十多个国家的运动员入驻军运村，中国代表团参赛队员也已经准备就绪。
除设置常规赛项外，还设有军事5项，空军5项，海军5项，跳伞、定向越野等富有军事特色的比赛项目。	除设置常规赛项外，还设有军事五项，空军五项，海军五项，跳伞、定向越野等富有军事特色的比赛项目。
开幕式全程2小时10分钟左右，其中文艺演出约50分钟。	开幕式全程二小时十分钟左右，其中文艺演出约五十分钟。
这里是武汉体育中心第7届世界军人运动会开幕式，10月18号晚上8点将在这里拉开帷幕。	这里是武汉体育中心第七届世界军人运动会开幕式，十月十八号晚上八点将在这里拉开帷幕。
来了之后发现新疆的人更美，不仅是外表，而且内心也非常的善良淳朴。我在这儿也结交了很多朋友。	来了之后发现新疆的人更美，不仅是外表，而且内心也非常的善良淳朴。我在这也结交了很多朋友。
连日来由中央广播电视总台制作的此时此刻国庆70周年盛典。	连日来由中央广播电视总台制作的此时此刻国庆七十周年盛典。
增速比上月末高0.2个百分点。初步统计，前三季度社会融资规模增量累计为18.74万亿元。	增速比上月末高零点二个百分点。初步统计，前三季度社会融资规模增量累计为十八点七四万亿元。
其中对实体经济发放的人民币贷款增加13.9万亿元。	其中对实体经济发放的人民币贷款增加十三点九万亿元。
今天交通运输部科学研究院发布，9月中国运输生产指数为175.7点。	今天交通运输部科学研究院发布，九月中国运输生产指数为一百七十五点七点。
同比增长4.3%，保持基本平稳。今年7~8月暑运期间，高铁民航客运量较快增长。	同比增长百分之四点三，保持基本平稳。今年七到八月暑运期间，高铁民航客运量较快增长。
一定程度释放了部分9月需求。	一定程度释放了部分九月需求。
第126届中国进出口商品交易会即广交会今天在广州开幕。本届广交会展出商品超过16万种。	第一百二十六届中国进出口商品交易会即广交会今天在广州开幕。本届广交会展出商品超过十六万种。
中国人民银行今天发布数据显示，9月末广义货币m二同比增长8.4%。	中国人民银行今天发布数据显示，九月末广义货币m二同比增长百分之八点四。
第5届中国互联网加大学生创新创业大赛冠军争夺赛昨晚在杭州落幕。	第五届中国互联网加大学生创新创业大赛冠军争夺赛昨晚在杭州落幕。
今天北京市2019年积分落户申报审核工作结束，今年对应的最低分值为93.58分。	今天北京市二零一九年积分落户申报审核工作结束，今年对应的最低分值为九十三点五八分。
实行同分同落，实际公示名单共6007人，取得落户资格人员经公示无异议的可办理常住户口。	实行同分同落，实际公示名单共六千零七人，取得落户资格人员经公示无异议的可办理常住户口。
中国第36次南极科考队今天启程，雪龙二号也同时从深圳起航。	中国第三十六次南极科考队今天启程，雪龙二号也同时从深圳起航。
这是雪龙号和雪龙二号首次双船出海执行科考任务。科考历时半年，预计2020年4月中旬返回。	这是雪龙号和雪龙二号首次双船出海执行科考任务。科考历时半年，预计二零二零年四月中旬返回。
多条河流冰层厚度达5厘米左右，开始进入流冰期比去年提前将近一周。	多条河流冰层厚度达五厘米左右，开始进入流冰期比去年提前将近一周。
叙利亚政府军14号进驻北部重镇曼笔记等多个叙库尔德武装控制区，同时土耳其也将目标锁定慢笔记。	叙利亚政府军十四号进驻北部重镇曼笔记等多个叙库尔德武装控制区，同时土耳其也将目标锁定慢笔记。
另据报道，美国总统特朗普14号签署行政令，授权美国相关部门对包括土耳其多位部长在内的人员实施制裁。	另据报道，美国总统特朗普十四号签署行政令，授权美国相关部门对包括土耳其多位部长在内的人员实施制裁。
此外美军军官14号称，美军仍有部队驻扎在曼比基，不过这些部队正准备撤离。针对当前局势。	此外美军军官十四号称，美军仍有部队驻扎在曼比基，不过这些部队正准备撤离。针对当前局势。
据日本媒体报道，截至当地时间15号19点，海贝斯已经在日本造成至少67人死亡。	据日本媒体报道，截至当地时间十五号十九点，海贝斯已经在日本造成至少六十七人死亡。
本台消息，2019中国海洋经济博览会开幕之际，中共中央总书记国家主席中央军委主席习近平发来贺信。	本台消息，二零一九中国海洋经济博览会开幕之际，中共中央总书记国家主席中央军委主席习近平发来贺信。
14号至15号，中共中央政治局常委国务院总理李克强在陕西西安咸阳考察，他强调。	十四号至十五号，中共中央政治局常委国务院总理李克强在陕西西安咸阳考察，他强调。
11世班禅向党中央敬献唐卡。	十一世班禅向党中央敬献唐卡。
苏州工业园区联合协调理事会第20次会议，天津生态城联合协调理事会第11次会议。	苏州工业园区联合协调理事会第二十次会议，天津生态城联合协调理事会第十一次会议。
随后韩正和王瑞杰共同主持4个双边合作机制会议。	随后韩正和王瑞杰共同主持四个双边合作机制会议。
11世班禅额尔德尼却即节部向党中央敬献唐卡仪式今天在北京举行。	十一世班禅额尔德尼却即节部向党中央敬献唐卡仪式今天在北京举行。
中共中央政治局委员中央办公厅主任丁学祥接受了敬献的唐卡。在举国欢庆新中国成立70周年之际。	中共中央政治局委员中央办公厅主任丁学祥接受了敬献的唐卡。在举国欢庆新中国成立七十周年之际。
双方宣布中新双边自贸协定升级版将于10月16号正式生效。	双方宣布中新双边自贸协定升级版将于十月十六号正式生效。
中央纪委国家监委公开曝光在不忘初心牢记使命主题教育期间查处的8起典型案例。	中央纪委国家监委公开曝光在不忘初心牢记使命主题教育期间查处的八起典型案例。
现在朱有勇团队有30多名研究生和博士生，每年100多天他们都驻扎在扶贫一线，指导培训农民。	现在朱有勇团队有三十多名研究生和博士生，每年一百多天他们都驻扎在扶贫一线，指导培训农民。
"也为乡村培养了一批科技人才。2019年澜沧县冬季马铃薯种植已经超过15,000亩。"	也为乡村培养了一批科技人才。二零一九年澜沧县冬季马铃薯种植已经超过十万五千亩。
零下三期种植超过7000亩，总产值达到5亿元，预计今年底将有7.5万人脱贫。	零下三期种植超过七千亩，总产值达到五亿元，预计今年底将有七点五万人脱贫。
新增高铁里程超过1000公里。我国八纵八横高铁网进一步加密。	新增高铁里程超过一零零零公里。我国八纵八横高铁网进一步加密。
早上7点，郑渝高铁郑湘段首发列车从郑州东站始发前往湖北襄阳，新线的开通运营。	早上七点，郑渝高铁郑湘段首发列车从郑州东站始发前往湖北襄阳，新线的开通运营。
7:26，正负高铁首发从郑州东站始发，政府高铁以郑州为起点。	七点二十六，正负高铁首发从郑州东站始发，政府高铁以郑州为起点。
欧洲6国宣布加入对伊朗的贸易结算机制，贸易往来支持工具。	欧洲六国宣布加入对伊朗的贸易结算机制，贸易往来支持工具。
日前中央纪委国家监委公开曝光，在主题教育期间，有关地方纪委监委查处的8起典型案例。	日前中央纪委国家监委公开曝光，在主题教育期间，有关地方纪委监委查处的八起典型案例。
这8起典型案例分别是河北省保定市徐水区委原书记苏树峰等人落实管党治党责任不力。	这八起典型案例分别是河北省保定市徐水区委原书记苏树峰等人落实管党治党责任不力。
文章指出，5个多月来香港发生的这些破坏法治破坏治安的暴力犯罪行为，明显具有恐怖主义性质。	文章指出，五个多月来香港发生的这些破坏法治破坏治安的暴力犯罪行为，明显具有恐怖主义性质。
种粮大户王福军正忙着给小麦灌溉，尝到了种植优质小麦的甜头，今年他又多流转了300亩土地。	种粮大户王福军正忙着给小麦灌溉，尝到了种植优质小麦的甜头，今年他又多流转了三百亩土地。
12月1号是世界艾滋病日，国家卫健委发布的数据显示，目前我国艾滋病经输血传播基本阻断。	十二月一号是世界艾滋病日，国家卫健委发布的数据显示，目前我国艾滋病经输血传播基本阻断。
种植面积达到了3000亩。	种植面积达到了三千亩。
截至今年10月底，全国共报告存活的艾滋病感染者95.8万，整体疫情持续处于低流行水平。	截至今年十月底，全国共报告存活的艾滋病感染者九十五点八万，整体疫情持续处于低流行水平。
中央广播电视总台大型文化节目故事里的中国今晚8点档将在我台综合频道播出第8期。	中央广播电视总台大型文化节目故事里的中国今晚八点档将在我台综合频道播出第八期。
伊朗希望欧盟6国的加入能够为这一结算机制带来更多的能量。	伊朗希望欧盟六国的加入能够为这一结算机制带来更多的能量。
在今年我们的优质小麦比普通小麦每一斤高出1毛2，再加上政府补贴。	在今年我们的优质小麦比普通小麦每一斤高出一毛二，再加上政府补贴。
为了促进与伊朗的合法贸易，6国现在正式启动程序，加入贸易往来支持工具结算机制。	为了促进与伊朗的合法贸易，六国现在正式启动程序，加入贸易往来支持工具结算机制。
欧洲六国日前宣布加入对伊朗的贸易结算机制，贸易往来支持工具。伊朗方面11月30号表示。	欧洲六国日前宣布加入对伊朗的贸易结算机制，贸易往来支持工具。伊朗方面十一月三十号表示。
那就是欧盟继续坚定支持和履行伊核协议。2019年1月英法德宣布设立贸易往来支持工具结算机制。	那就是欧盟继续坚定支持和履行伊核协议。二零一九年一月英法德宣布设立贸易往来支持工具结算机制。
最初建立贸易往来支持工具的英法德三国发表声明表示，欧洲6国的加入对外释放了清晰的信号。	最初建立贸易往来支持工具的英法德三国发表声明表示，欧洲六国的加入对外释放了清晰的信号。
综合收入我们今年合作社增收20多万。	综合收入我们今年合作社增收二十多万。
当地时间11月30号，德国社会民主党选举出两个新任主席诺贝特瓦尔特博尔扬斯和萨斯基亚艾斯肯。	当地时间十一月三十号，德国社会民主党选举出两个新任主席诺贝特瓦尔特博尔扬斯和萨斯基亚艾斯肯。
该竞技场是在1964年东京奥运会主场馆原国立竞技场原址上重建而成。	该竞技场是在一九六四年东京奥运会主场馆原国立竞技场原址上重建而成。
11月30号2020年东京奥运会和残奥会主场馆国立竞技场宣布竣工。	十一月三十号两千零二十年东京奥运会和残奥会主场馆国立竞技场宣布竣工。
工期建设历时三年，工程费用为1529亿日元，约合98亿元人民币。	工期建设历时三年，工程费用为一千五百二十九亿日元，约合九十八亿元人民币。
竞技场内可容纳6万名观众同时观看比赛，其中包括500个轮椅席位。	竞技场内可容纳六万名观众同时观看比赛，其中包括五百个轮椅席位。
这里将是2020年东京奥运会以及残奥会的开幕式和闭幕式举办地。	这里将是二零二零年东京奥运会以及残奥会的开幕式和闭幕式举办地。
但是距离老王家20多公里，武陟县最大的食品加工企业却为买粮犯难。	但是距离老王家二十多公里，武陟县最大的食品加工企业却为买粮犯难。
还需要从外地采购，每年2万吨到3万吨。	还需要从外地采购，每年二万吨到三万吨。
河南常年种植小麦8500万亩以上，产量占全国的1/4左右。如何既保粮食稳产。	河南常年种植小麦八千五百万亩以上，产量占全国的四分之一左右。如何既保粮食稳产。
今天是12月1号星期日，农历11月初六，欢迎收看新闻联播节目。	今天是十二月一号星期日，农历十一月初六，欢迎收看新闻联播节目。
并从2016年开始推广发展优质专用小麦种植，并根据气候土壤的特点。	并从二零一六年开始推广发展优质专用小麦种植，并根据气候土壤的特点。
光这个运输费用能减少3%~5%。	光这个运输费用能减少百分之三到百分之五。
目前河南优质小麦基本实现产地经营规模化，千亩以上单品种规模连片种植区达2265个。	目前河南优质小麦基本实现产地经营规模化，千亩以上单品种规模连片种植区达两千两百六十五个。
今年秋波河南优质小麦种植面积达到1350万亩，占全省小麦种植总面积的15.8%。	今年秋波河南优质小麦种植面积达到一千三百五十万亩，占全省小麦种植总面积的百分之十五点八。
2018年11月5号，习近平总书记在首届中国国际进口博览会上宣布。	二零一八年十一月五号，习近平总书记在首届中国国际进口博览会上宣布。
系列报道壮丽70年，奋斗新时代，重温嘱托，看变化今天播出。河南省牢记习近平总书记嘱托。	系列报道壮丽七十年，奋斗新时代，重温嘱托，看变化今天播出。河南省牢记习近平总书记嘱托。
预计到2020年优质小麦面积将达到1500万亩。	预计到二零二零年优质小麦面积将达到一千五百万亩。
高标准建设上海自由贸易试验区新片区，推进规划实施等12章。	高标准建设上海自由贸易试验区新片区，推进规划实施等十二章。
规划期至2025年，展望到2035年。	规划期至二零二五年，展望到二零三五年。
国家副主席王岐山一号在广州出席2019从都国际论坛开幕式并至此。王岐山表示，和平与发展是时代主题。	国家副主席王岐山一号在广州出席二零一九从都国际论坛开幕式并至此。王岐山表示，和平与发展是时代主题。
中国愿同国际社会携手合作，全面落实2030年可持续发展议程，积极参与应对气候变化国际合作。	中国愿同国际社会携手合作，全面落实二零三零年可持续发展议程，积极参与应对气候变化国际合作。
王岐山出席2019从都国际论坛开幕式并致辞。	王岐山出席二零一九从都国际论坛开幕式并致辞。
2015年朱游泳来到中国工程院对口扶贫县，云南澜沧拉护族自治县扶贫。	二零一五年朱游泳来到中国工程院对口扶贫县，云南澜沧拉护族自治县扶贫。
将绿色农产品卖出大山。60名学员全部来自澜沧县20多个乡镇。	将绿色农产品卖出大山。六十名学员全部来自澜沧县二十多个乡镇。
已经举办过24个技能培训班，培训农户超过数千人。	已经举办过二十四个技能培训班，培训农户超过数千人。
今年64岁的朱有勇出生于云南普通农家，1977年考入云南农业大学。	今年六十四岁的朱有勇出生于云南普通农家，一九七七年考入云南农业大学。
1982年开始从事利用生物多样性控制病虫害的科学研究，30多年来都有勇带领团队研发的。	一九八二年开始从事利用生物多样性控制病虫害的科学研究，三十多年来都有勇带领团队研发的。
2016年开始，朱友勇在田间地头手把手的教村民怎么种马铃薯。	二零一六年开始，朱友勇在田间地头手把手的教村民怎么种马铃薯。
遗传多样性控制水稻病害技术，在我国10个省区市推广，并获得联合国粮农组织科研一等奖。	遗传多样性控制水稻病害技术，在我国十个省区市推广，并获得联合国粮农组织科研一等奖。
它研发的物种多样性控制作物病害技术在国内外应用于3亿多亩旱地作物。	它研发的物种多样性控制作物病害技术在国内外应用于三亿多亩旱地作物。
这两项技术都减少了60%的农药使用，并增产20%~30%。	这两项技术都减少了百分之六十的农药使用，并增产百分之二十到百分之三十。
推进国家治理体系和治理能力现代化的总体要求和目标，对坚持和完善13个方面制度体系作出部署。	推进国家治理体系和治理能力现代化的总体要求和目标，对坚持和完善十三个方面制度体系作出部署。
为实现两个100年奋斗目标，实现中华民族伟大复兴的中国梦努力奋斗。	为实现两个一百年奋斗目标，实现中华民族伟大复兴的中国梦努力奋斗。
本台消息，11月1号上午应乌兹别克斯坦共和国总理阿里波夫泰王国总理巴育邀请。	本台消息，十一月一号上午应乌兹别克斯坦共和国总理阿里波夫泰王国总理巴育邀请。
第18次会议，并对乌兹别克斯坦进行正式访问，赴泰国出席第22次中国东盟10+1领导人会议。	第十八次会议，并对乌兹别克斯坦进行正式访问，赴泰国出席第二十二次中国东盟十加一领导人会议。
第22次东盟与中日韩10+3领导人会议和第14届东亚峰会，并对泰国进行政治访问。	第二十二次东盟与中日韩十加三领导人会议和第十四届东亚峰会，并对泰国进行政治访问。
第十三届全国政协党组理论学习中心组11月1号举行2019年第4次集体学习。	第十三届全国政协党组理论学习中心组十一月一号举行二零一九年第四次集体学习。
联合国贸易和发展会议发布2019年海运报告，积极评价一带一路倡议。	联合国贸易和发展会议发布二零一九年海运报告，积极评价一带一路倡议。
各位观众，今天的新闻联播大约需要48分钟，接下来请看详细报道。	各位观众，今天的新闻联播大约需要四十八分钟，接下来请看详细报道。
双方要以两国元首重要共识为指引，以明年中俄建交40周年为契机，推动中俄关系进入高质量发展新阶段。	双方要以两国元首重要共识为指引，以明年中俄建交四十周年为契机，推动中俄关系进入高质量发展新阶段。
9月25号。	九月二十五号。
瓦伦西亚表示，新中国70年来取得的巨大成就对全世界亦具有重要意义。	瓦伦西亚表示，新中国七十年来取得的巨大成就对全世界亦具有重要意义。
到2035年通过加强国土空间规划实施管理，严守三条控制线。	到二零三五年通过加强国土空间规划实施管理，严守三条控制线。
我们就能够实现两个100年的奋斗目标，就能够立于不败之地。	我们就能够实现两个一百年的奋斗目标，就能够立于不败之地。
它由13个部分构成，其中党的领导。	它由十三个部分构成，其中党的领导。
中国共产党第十九届中央委员会第4次全体会议公报一经发布立刻在各地引起热烈反响。	中国共产党第十九届中央委员会第四次全体会议公报一经发布立刻在各地引起热烈反响。
大家纷纷表示，要咬定青山绝不松劲儿，深入学习贯彻全会精神。	大家纷纷表示，要咬定青山绝不松劲，深入学习贯彻全会精神。
今天第二届进博会国家展所有搭建工作全部完成，此次进博会共吸引了3000多家企业参展。	今天第二届进博会国家展所有搭建工作全部完成，此次进博会共吸引了三千多家企业参展。
其中超过1000家是首次亮相。借着进博会这个窗口越来越多的国家和企业。	其中超过一千家是首次亮相。借着进博会这个窗口越来越多的国家和企业。
制造他的企业去年在进博会上一下就拿下了8.41亿美元的意向合作协议。	制造他的企业去年在进博会上一下就拿下了八点四一亿美元的意向合作协议。
2018年4次主动降低关税，平均关税税率从9.8%降到7.5%。	二零一八年四次主动降低关税，平均关税税率从百分之九点八降到百分之七点五。
93学社中央主席武维华，台盟中央主席苏辉，全国工商联主席高云龙。	九三学社中央主席武维华，台盟中央主席苏辉，全国工商联主席高云龙。
中华人民共和国外商投资法将于明年1月1日实施，优化营商环境条例也于近日公布。	中华人民共和国外商投资法将于明年一月一日实施，优化营商环境条例也于近日公布。
而世界银行新近发布的全球营商环境报告当中，中国营商环境排名更是由去年的第46位上升至第31位。	而世界银行新近发布的全球营商环境报告当中，中国营商环境排名更是由去年的第四十六位上升至第三十一位。
水利部今天发布针对近几个月来南方部分省份持续出现的旱情，国家已安排1亿元水利救灾资金。	水利部今天发布针对近几个月来南方部分省份持续出现的旱情，国家已安排一亿元水利救灾资金。
第29届中国新闻奖评选结果今天揭晓，来自全国各级各类媒体的346件作品获得中国新闻奖。	第二十九届中国新闻奖评选结果今天揭晓，来自全国各级各类媒体的三百四十六件作品获得中国新闻奖。
郑旺高铁建成通车后，重庆至河南郑州将从8小时缩短到4小时，到北京只需6小时。	郑旺高铁建成通车后，重庆至河南郑州将从八小时缩短到四小时，到北京只需六小时。
其中特别奖5件，一等奖60件，含10件，新闻名专栏二等奖108件，三等奖173件。	其中特别奖五件，一等奖六十件，含十件，新闻名专栏二等奖一百零八件，三等奖一百七十三件。
此次会议提出了加快实现中国梦的机制方向，而两个100年构想也将在制度完善的基础上加速推进。	此次会议提出了加快实现中国梦的机制方向，而两个一百年构想也将在制度完善的基础上加速推进。
低于2017年的4.1%，以及历史平均水平3%。不过报告强调。	低于二零一七年的百分之四点一，以及历史平均水平百分之三。不过报告强调。
联合国贸易和发展会议近日发布2019年海运报告，积极评价一带一路倡议，对全球贸易的积极推动作用。	联合国贸易和发展会议近日发布二零一九年海运报告，积极评价一带一路倡议，对全球贸易的积极推动作用。
预计2019~2024年海运贸易将稳定在3.4%的增长率。	预计二零一九到二零二四年海运贸易将稳定在百分之三点四的增长率。
该浮船物长约220米，宽约48米，可建造和修理最大8万载重吨的船舶，预计将于明年投入使用。	该浮船物长约两百二十米，宽约四十八米，可建造和修理最大八万载重吨的船舶，预计将于明年投入使用。
决议案规定了谈何调查的程序和规则。每众院9月24号启动谈合调查。	决议案规定了谈何调查的程序和规则。每众院九月二十四号启动谈合调查。
起因是一名情报界人士匿名检举特朗普7月在同乌克兰总统则连司机通话时。	起因是一名情报界人士匿名检举特朗普七月在同乌克兰总统则连司机通话时。
伊拉克总统萨利赫10月31号宣布，伊拉克正着手制定新选举法并改组选举委员会。	伊拉克总统萨利赫十月三十一号宣布，伊拉克正着手制定新选举法并改组选举委员会。
针对禁止报出的波音737ng型飞机被发现了机身出现裂缝一事。美国波音公司10月31号宣布。	针对禁止报出的波音七百三十七ng型飞机被发现了机身出现裂缝一事。美国波音公司十月三十一号宣布。
经过检查，目前已发现约50架相关机型飞机存在裂缝，这些飞机都已停飞，需要接受进一步检查和维修。	经过检查，目前已发现约五十架相关机型飞机存在裂缝，这些飞机都已停飞，需要接受进一步检查和维修。
美国加州山火近日在持续的肆虐，当地时间10月31号加州南部的圣贝纳迪诺县又燃起了新的山火。	美国加州山火近日在持续的肆虐，当地时间十月三十一号加州南部的圣贝纳迪诺县又燃起了新的山火。
多处民宅被烧毁，1300多名居民被迫撤离，500多名消防员前往灭火。	多处民宅被烧毁，一千三百多名居民被迫撤离，五百多名消防员前往灭火。
习近平指出，中共十九届四中全会是中共中央站在两个100年奋斗目标的历史交汇点上召开的。	习近平指出，中共十九届四中全会是中共中央站在两个一百年奋斗目标的历史交汇点上召开的。
习近平强调，在新中国成立70周年的重要历史时刻。	习近平强调，在新中国成立七十周年的重要历史时刻。
习近平致信祝贺中国科学院建院70周年强调加快打造原始创新策源地，加快突破关键核心技术。	习近平致信祝贺中国科学院建院七十周年强调加快打造原始创新策源地，加快突破关键核心技术。
本台消息在中国科学院建院70周年之际，中共中央总书记国家主席中央军委主席习近平发来贺信。	本台消息在中国科学院建院七十周年之际，中共中央总书记国家主席中央军委主席习近平发来贺信。
代表党中央向全院科技工作者和干部职工致以诚挚的问候。习近平在贺信中指出，70年来。	代表党中央向全院科技工作者和干部职工致以诚挚的问候。习近平在贺信中指出，七十年来。
李克强离京出席上海合作组织成员国政府首脑理事会第18次会议，并正式访问乌兹别克斯坦。	李克强离京出席上海合作组织成员国政府首脑理事会第十八次会议，并正式访问乌兹别克斯坦。
中共中央政治局常委国务院总理李克强作出批示指出，中国科学院建院70年来坚持面向国家重大需求。	中共中央政治局常委国务院总理李克强作出批示指出，中国科学院建院七十年来坚持面向国家重大需求。
一号上午中国科学院举行建院70周年庆祝大会，会上宣读了习近平的贺信和李克强的批示。	一号上午中国科学院举行建院七十周年庆祝大会，会上宣读了习近平的贺信和李克强的批示。
习近平总书记的贺信充分肯定了中科院70年来取得的巨大成就，也为中科院的未来发展指明了方向。	习近平总书记的贺信充分肯定了中科院七十年来取得的巨大成就，也为中科院的未来发展指明了方向。
70年来，中科院广大科研人员攻坚克难，勇攀高峰，取得了一批又一批举世瞩目的重大科技成果。	七十年来，中科院广大科研人员攻坚克难，勇攀高峰，取得了一批又一批举世瞩目的重大科技成果。
国家副主席王岐山31号在佛山会见菲律宾总统杜特尔特。	国家副主席王岐山三十一号在佛山会见菲律宾总统杜特尔特。
王岐山表示，总统先生莅临2019年国际篮联篮球世界杯比赛使赛事更加耀眼。	王岐山表示，总统先生莅临二零一九年国际篮联篮球世界杯比赛使赛事更加耀眼。
本台消息今天出版的第17期求是杂志发表评论员文章，奋力走好新时代的长征路。	本台消息今天出版的第十七期求是杂志发表评论员文章，奋力走好新时代的长征路。
各位观众，今天的新闻联播节目大约需要42分钟，接下来请您收看详细内容。	各位观众，今天的新闻联播节目大约需要四十二分钟，接下来请您收看详细内容。
新时代的长征路直接通向两个100年奋斗目标，直接通向实现中华民族的伟大复兴。	新时代的长征路直接通向两个一百年奋斗目标，直接通向实现中华民族的伟大复兴。
这样一来每年上万件此类货物运输的审批时间将比原来缩短80%。	这样一来每年上万件此类货物运输的审批时间将比原来缩短百分之八十。
晚走一天一天将近损失30万。	晚走一天一天将近损失三十万。
从事审判工作25年，他始终公正司法，所办的案件无一错案无一上访。	从事审判工作二十五年，他始终公正司法，所办的案件无一错案无一上访。
患尿毒症的最后4年里，他仍然带病坚持工作。	患尿毒症的最后四年里，他仍然带病坚持工作。
去年的9月1号是李庆军最后一次在单位加班，第二天他做了换肾手术。	去年的九月一号是李庆军最后一次在单位加班，第二天他做了换肾手术。
术后的第26天因病情恶化，李庆军不幸离世，年仅54岁。	术后的第二十六天因病情恶化，李庆军不幸离世，年仅五十四岁。
重乡情，但为案件说情打招呼的事儿，李庆军从来不干。	重乡情，但为案件说情打招呼的事，李庆军从来不干。
后来想了想，这不是庆军同学不近人情，而是80年前人人平等。	后来想了想，这不是庆军同学不近人情，而是八十年前人人平等。
2014年李庆军被确诊患有尿毒症。	二零一四年李庆军被确诊患有尿毒症。
我一到单位干起活来，那浑身是劲儿。	我一到单位干起活来，那浑身是劲。
李庆军去世后，家人在他的办公室里发现了19本日记。	李庆军去世后，家人在他的办公室里发现了十九本日记。
球拍霸是约200米长的直线加速器，球拍面是周长240米的存储环。	球拍霸是约两百米长的直线加速器，球拍面是周长两百四十米的存储环。
在地下6米深的隧道中，接近光速运行的正负电子，在这里每秒上亿次的对撞，不断探索着物质构成的奥秘。	在地下六米深的隧道中，接近光速运行的正负电子，在这里每秒上亿次的对撞，不断探索着物质构成的奥秘。
对撞机建造涉及10多个门类的高新技术，数千台设备，90%以上都靠国内自行设计制造。	对撞机建造涉及十多个门类的高新技术，数千台设备，百分之九十以上都靠国内自行设计制造。
1984年10月7号，北京政府电子对撞机工程破土动工。	一九八四年十月七号，北京政府电子对撞机工程破土动工。
在全国数百个单位上万人的精心研制安装调试下，1988年10月16号。	在全国数百个单位上万人的精心研制安装调试下，一九八八年十月十六号。
北京正负电子对撞机运行后，短短几年内就在20~50亿电子伏特这一能区取得一系列新发现。	北京正负电子对撞机运行后，短短几年内就在二十到五十亿电子伏特这一能区取得一系列新发现。
文章指出，中国有近14亿人口的大市场，有世界上规模最大的中等收入群体。	文章指出，中国有近十四亿人口的大市场，有世界上规模最大的中等收入群体。
本台消息对于激进示威者8月31号在香港多区实施违法及暴力行为。	本台消息对于激进示威者八月三十一号在香港多区实施违法及暴力行为。
为制止暴力事件恶化，警方在港铁旺角和太子站共拘捕63人。	为制止暴力事件恶化，警方在港铁旺角和太子站共拘捕六十三人。
此外，警方8月31号在铜锣湾和西环逮捕11人，并缴获大量假记者证。	此外，警方八月三十一号在铜锣湾和西环逮捕十一人，并缴获大量假记者证。
包括多位立法会议员在内的香港各界人士，今天强烈谴责8月31号在香港多地发生的暴力事件。	包括多位立法会议员在内的香港各界人士，今天强烈谴责八月三十一号在香港多地发生的暴力事件。
39名建制派立法会议员9月1号发表联署声明。	三十九名建制派立法会议员九月一号发表联署声明。
全港各区工商联9月1号也发表声明，对示威者不断将暴力升级，严重威胁警务人员及市民人身安全的行径。	全港各区工商联九月一号也发表声明，对示威者不断将暴力升级，严重威胁警务人员及市民人身安全的行径。
9月1号在澳门回归贺礼陈列馆开幕。本次展览由澳门特区政府、澳门中联办。	九月一号在澳门回归贺礼陈列馆开幕。本次展览由澳门特区政府、澳门中联办。
展览于9月1号至9号对公众开放。	展览于九月一号至九号对公众开放。
以及香港和澳门特别行政区。全天播音21小时分为新闻、财经、生活、文化、音乐等5大板块。	以及香港和澳门特别行政区。全天播音二十一小时分为新闻、财经、生活、文化、音乐等五大板块。
作为总台区域特色鲜明的传播平台，大湾区之声还将依托总台5g+4k8k加AI战略布局。	作为总台区域特色鲜明的传播平台，大湾区之声还将依托总台五g+四k八k加AI战略布局。
今天2019中国企业500强榜单正式出炉。	今天二零一九中国企业五百强榜单正式出炉。
本届入榜企业营业收入总额为79.10万亿元，较上年增长了11.14%。	本届入榜企业营业收入总额为七十九点一零万亿元，较上年增长了百分之十一点一四。
"实现净利润35,320.95亿元，较去年增长10.28%。"	"实现净利润三十五,三百二十点九五亿元，较去年增长百分之十点二八。"
企业在进口货物申报时，不再需要向海关一次性递交105项申报项目。	企业在进口货物申报时，不再需要向海关一次性递交一百零五项申报项目。
而是第一步申报9项内容，即可将货物提离港口，而后进行第二步补充申报。	而是第一步申报九项内容，即可将货物提离港口，而后进行第二步补充申报。
大大压缩了企业通关时间和成本，60万家外贸企业将因此受益。	大大压缩了企业通关时间和成本，六十万家外贸企业将因此受益。
共破获各类案件3万余起，抓获网上逃犯1.1万余人。	共破获各类案件三万余起，抓获网上逃犯一点一万余人。
缴获倒卖的车票及假票2.1万余张，查获各类易燃易爆危险品25万件。	缴获倒卖的车票及假票二点一万余张，查获各类易燃易爆危险品二十五万件。
去年的四五月份对美贸易下滑的比较厉害，有一个企业由于订单的数量减少，28条生产线。	去年的四五月份对美贸易下滑的比较厉害，有一个企业由于订单的数量减少，二十八条生产线。
他的公司总部虽然设在弗罗里达，但90%的产品都在中国生产。	他的公司总部虽然设在弗罗里达，但百分之九十的产品都在中国生产。
有87%的受访企业表示没有或没有计划将经营活动迁出中国。	有百分之八十七的受访企业表示没有或没有计划将经营活动迁出中国。
有82%的受访企业表示，2019年仍将中国列为公司的战略重点，甚至是首要战略重点。	有百分之八十二的受访企业表示，二零一九年仍将中国列为公司的战略重点，甚至是首要战略重点。
抗议首相约翰逊让议会在夏季休会结束后再度休会至10月14号。	抗议首相约翰逊让议会在夏季休会结束后再度休会至十月十四号。
美国德克萨斯州奥德萨市附近8月31号再度发生严重枪击事件。	美国德克萨斯州奥德萨市附近八月三十一号再度发生严重枪击事件。
事件中包括枪手在内的5人死亡，21人受伤。	事件中包括枪手在内的五人死亡，二十一人受伤。
之后枪手被击毙，枪手为一名30多岁的白人男性，身份和作案动机有待进一步调查。	之后枪手被击毙，枪手为一名三十多岁的白人男性，身份和作案动机有待进一步调查。
就在8月3号德州埃尔帕索市的一家沃尔玛超市发生一起针对外来移民的枪击事件造成22人死亡。	就在八月三号德州埃尔帕索市的一家沃尔玛超市发生一起针对外来移民的枪击事件造成二十二人死亡。
美国去年5月宣布单方面退出伊核协议，随后重启对伊制裁，涉及石油出口、金融、航运等多个领域。	美国去年五月宣布单方面退出伊核协议，随后重启对伊制裁，涉及石油出口、金融、航运等多个领域。
受制裁影响，2018年下半年至2019年初，伊朗经济一度受到冲击。	受制裁影响，二零一八年下半年至二零一九年初，伊朗经济一度受到冲击。
阿富汗北部昆都市省首府昆都市市8月31号遭塔利班袭击。	阿富汗北部昆都市省首府昆都市市八月三十一号遭塔利班袭击。
此外，塔利班当天还在昆都市市制造了一起自杀式炸弹袭击，造成10名警察和平民死亡。	此外，塔利班当天还在昆都市市制造了一起自杀式炸弹袭击，造成十名警察和平民死亡。
企业同时拓展多元化的国际市场，今年以来在欧洲市场的增量超过了30%。	企业同时拓展多元化的国际市场，今年以来在欧洲市场的增量超过了百分之三十。
在仓库里价值2000万美元的座椅都将在月内送往世界各地。	在仓库里价值两千万美元的座椅都将在月内送往世界各地。
今年以来，湖州出口向一带一路沿线国家，欧洲等新兴市场年均增长都在10%以上。	今年以来，湖州出口向一带一路沿线国家，欧洲等新兴市场年均增长都在百分之十以上。
除了高性价比和电动之外，它的安全性对我们降低了工人受伤的风险，我们今年要买1500台。	除了高性价比和电动之外，它的安全性对我们降低了工人受伤的风险，我们今年要买一千五百台。
而6月份刚成立的太湖新区高起点规划，正在积极构建数字经济、新能源汽车、生物医药等现代绿色产业体系。	而六月份刚成立的太湖新区高起点规划，正在积极构建数字经济、新能源汽车、生物医药等现代绿色产业体系。
十九大以来重要文献选编上册，收入自2017年10月党的十九大召开。	十九大以来重要文献选编上册，收入自二零一七年十月党的十九大召开。
至2019年3月十三届全国人大二次会议闭幕，这段时间内的重要文献。	至二零一九年三月十三届全国人大二次会议闭幕，这段时间内的重要文献。
共65篇，约66万字。	共六十五篇，约六十六万字。
其中习近平总书记的文稿26篇，其他中央领导同志的文稿17篇。	其中习近平总书记的文稿二十六篇，其他中央领导同志的文稿十七篇。
有14篇重要文献是第一次公开发表。	有十四篇重要文献是第一次公开发表。
中共中央全国人大、国务院、中央军委的有关文件22篇。	中共中央全国人大、国务院、中央军委的有关文件二十二篇。
香港特区政府香港警方强烈谴责激进示威者8月31号的违法及暴力行为。	香港特区政府香港警方强烈谴责激进示威者八月三十一号的违法及暴力行为。
壮阔70载，奋进新时代。10月1号上午庆祝中华人民共和国成立70周年大会。	壮阔七十载，奋进新时代。十月一号上午庆祝中华人民共和国成立七十周年大会。
20余万军民以盛大的阅兵仪式和群众游行欢庆共和国70华诞。	二十余万军民以盛大的阅兵仪式和群众游行欢庆共和国七十华诞。
本台消息，中华人民共和国中央军事委员会主席习近平10月1日签署通令。	本台消息，中华人民共和国中央军事委员会主席习近平十月一日签署通令。
嘉奖参加庆祝中华人民共和国成立70周年阅兵，全体人员。	嘉奖参加庆祝中华人民共和国成立七十周年阅兵，全体人员。
嘉奖令指出，在伟大的中华人民共和国成立70周年盛大庆典活动中，受阅部队作为共和国武装力量的代表。	嘉奖令指出，在伟大的中华人民共和国成立七十周年盛大庆典活动中，受阅部队作为共和国武装力量的代表。
热烈庆祝中华人民共和国成立70周年。	热烈庆祝中华人民共和国成立七十周年。
许多国家领导人致电或致函国家主席习近平，热烈祝贺中华人民共和国成立70周年。	许多国家领导人致电或致函国家主席习近平，热烈祝贺中华人民共和国成立七十周年。
韩国总统文在银表示，70年来中国在各领域取得了辉煌成就。	韩国总统文在银表示，七十年来中国在各领域取得了辉煌成就。
今天是10月1号星期二，农历9月初三。	今天是十月一号星期二，农历九月初三。
是中华人民共和国70华诞。	是中华人民共和国七十华诞。
习近平在讲话中指出，70年前的今天，毛泽东同志在这里。	习近平在讲话中指出，七十年前的今天，毛泽东同志在这里。
中国人民从此站起来了。这一伟大事件彻底改变了近代以后100多年。	中国人民从此站起来了。这一伟大事件彻底改变了近代以后一百多年。
70年来，全国各族人民。	七十年来，全国各族人民。
庆祝中华人民共和国成立70周年大会在京隆重举行。	庆祝中华人民共和国成立七十周年大会在京隆重举行。
今天是3月15号星期五，农历2月初九，欢迎收看新闻联播节目。	今天是三月十五号星期五，农历二月初九，欢迎收看新闻联播节目。
今年是新中国成立70周年，也是决胜全面建成小康社会的关键之年。	今年是新中国成立七十周年，也是决胜全面建成小康社会的关键之年。
本台消息新华社3月14号播发通讯，上下同心再出发。	本台消息新华社三月十四号播发通讯，上下同心再出发。
习近平总书记同出席2019年全国两会人大代表政协委员共商国事计时。	习近平总书记同出席二零一九年全国两会人大代表政协委员共商国事计时。
全国上下奋力拼搏，推进供给侧结构性改革，中国经济实现6.6%的增速的确来之不易。	全国上下奋力拼搏，推进供给侧结构性改革，中国经济实现百分之六点六的增速的确来之不易。
关于减税降费李克强说，今年大规模减税降费有利于激发1亿多市场主体活力。	关于减税降费李克强说，今年大规模减税降费有利于激发一亿多市场主体活力。
要确保新增城镇就业人数在1100万人以上，在实际工作中力争达到1300万人以上。	要确保新增城镇就业人数在一千一百万人以上，在实际工作中力争达到一千三百万人以上。
今年一是把高血压糖尿病等慢性病的门诊用药纳入医保报销范围，给予50%的报销，这将惠及4亿患者。	今年一是把高血压糖尿病等慢性病的门诊用药纳入医保报销范围，给予百分之五十的报销，这将惠及四亿患者。
持续释放内需潜力等6个领域。报告有2900多名人大代表，2100多名政协委员广泛讨论审议。	持续释放内需潜力等六个领域。报告有两千九百多名人大代表，两千一百多名政协委员广泛讨论审议。
郭伟介绍此次政府工作报告在全国两会期间进行了83处修改。	郭伟介绍此次政府工作报告在全国两会期间进行了八十三处修改。
新加坡等7国与阿拉伯国家联盟驻华使节和外交官在新疆、乌鲁木齐、喀什等地进行参观访问。	新加坡等七国与阿拉伯国家联盟驻华使节和外交官在新疆、乌鲁木齐、喀什等地进行参观访问。
44.3%，174.8%，39.9%和113.3%。	百分之四十四点三，百分之一百七十四点八，百分之三十九点九和百分之一百一十三点三。
去年底全国涉农贷款余额32.68万亿元，同比增长5.58%。	去年底全国涉农贷款余额三十二点六八万亿元，同比增长百分之五点五八。
民航局将督促相关单位在7个工作日内联系旅客，并在规定时间内给出处理意见。	民航局将督促相关单位在七个工作日内联系旅客，并在规定时间内给出处理意见。
比去年提前了10多天。	比去年提前了十多天。
至少推迟到6月底。欧盟方面此前曾表示对英国推迟脱欧持开放态度，但需说明推迟的目的和意义。	至少推迟到六月底。欧盟方面此前曾表示对英国推迟脱欧持开放态度，但需说明推迟的目的和意义。
在5个月内连续发生两次空难后，目前波音公司已暂停向客户交付t37-8及t37-9新飞机。	在五个月内连续发生两次空难后，目前波音公司已暂停向客户交付t三七-八及t三七-九新飞机。
王岐山和大会主席团成员在主席台就座，会议应出席代表2974人。	王岐山和大会主席团成员在主席台就座，会议应出席代表二千九百七十四人。
出席2948人，缺席26人，出席人数符合法定人数。上午9:00。	出席二千九百四十八人，缺席二十六人，出席人数符合法定人数。上午九点。
决议指出，会议充分肯定国务院过去一年的工作，同意报告提出的2019年经济社会发展总体要求政策取向。	决议指出，会议充分肯定国务院过去一年的工作，同意报告提出的二零一九年经济社会发展总体要求政策取向。
关于2018年国民经济和社会发展计划执行情况，与2019年国民经济和社会发展计划的决议。	关于二零一八年国民经济和社会发展计划执行情况，与二零一九年国民经济和社会发展计划的决议。
各国驻华使节旁听了大会。9:29，栗战书宣布。	各国驻华使节旁听了大会。九点二十九分，栗战书宣布。
本台消息，国家主席习近平15号在京签署第26号主席令，第26号主席令说。	本台消息，国家主席习近平十五号在京签署第二十六号主席令，第二十六号主席令说。
于2019年3月15日通过县域公布，自2020年1月1日起施行。	于二零一九年三月十五日通过县域公布，自二零二零年一月一日起施行。
为实现两个100年奋斗目标，实现中华民族伟大复兴的中国梦提供强大精神力量和舆论支持。	为实现两个一百年奋斗目标，实现中华民族伟大复兴的中国梦提供强大精神力量和舆论支持。
第26次全国高校党的建设工作会议15号在京召开。	第二十六次全国高校党的建设工作会议十五号在京召开。
第26次全国高校党的建设工作会议在京召开，王沪宁出席并讲话。	第二十六次全国高校党的建设工作会议在京召开，王沪宁出席并讲话。
全面深化改革。5年多来，一带一路从倡议变为现实，五通建设进展顺利。	全面深化改革。五年多来，一带一路从倡议变为现实，五通建设进展顺利。
文章强调，全党要认真贯彻落实习近平总书记提出的6项任务。	文章强调，全党要认真贯彻落实习近平总书记提出的六项任务。
5年多来五通建设进展顺利，一带一路从倡议变为现实。	五年多来五通建设进展顺利，一带一路从倡议变为现实。
郑州至卢森堡货运航线开辟的空中新丝路，已经从2014年的每周两班加密到现在的18班。	郑州至卢森堡货运航线开辟的空中新丝路，已经从二零一四年的每周两班加密到现在的十八班。
开通一年多来以通达全球6大洲的60个国家和地区的116个港口。	开通一年多来以通达全球六大洲的六十个国家和地区的一百一十六个港口。
与这条大通道紧密对接的中欧班列2018年共开行6300多列，同比增长72%。	与这条大通道紧密对接的中欧班列二零一八年共开行六三零零多列，同比增长百分之七十二。
实现了丝绸之路经济带和21世纪海上丝绸之路的无缝衔接。	实现了丝绸之路经济带和二十一世纪海上丝绸之路的无缝衔接。
其中返程班列2690列，同比增长111%。	其中返程班列两千六百九十列，同比增长百分之一百一十一。
"贸易总额由10,405亿美元增至10,912亿美元，年均增长1.2%。"	"贸易总额由十,四百零五亿美元增至十,九百一十二亿美元，年均增长百分之一点二。"
截至2018年底，我国已与122个国家和29个国际组织签署了一带一路建设合作协议。	截至二零一八年底，我国已与一百二十二个国家和二十九个国际组织签署了一带一路建设合作协议。
覆盖国内59个城市，欧洲15个国家，49个城市。	覆盖国内五十九个城市，欧洲十五个国家，四十九个城市。
改革开放40年先锋人物，今天带您认识为中国电影事业发展作出卓越贡献的电影艺术家谢晋。	改革开放四十年先锋人物，今天带您认识为中国电影事业发展作出卓越贡献的电影艺术家谢晋。
10年的努力打拼。2008年3月5号，胡晓燕作为首批农民工，全国人大代表。	十年的努力打拼。二零零八年三月五号，胡晓燕作为首批农民工，全国人大代表。
2012年胡晓燕通过公务员考试成为佛山三水区总工会的一名公职人员。	二零一二年胡晓燕通过公务员考试成为佛山三水区总工会的一名公职人员。
2008年10月17号谢晋于浙江上虞逝世。	二零零八年十月十七号谢晋于浙江上虞逝世。
朱锡昂1887年出生于广西玉林市博白县，1907年考入广东高等工业学堂。	朱锡昂一八八七年出生于广西玉林市博白县，一九零七年考入广东高等工业学堂。
1925年在日本留学期间加入中国共产党。	一九二五年在日本留学期间加入中国共产党。
此后辗转全国各地从事党的活动，1927年参加了广州起义。	此后辗转全国各地从事党的活动，一九二七年参加了广州起义。
1926年他建立了中共玉林地方组织的第一个支部，中共玉林县支部任支部书记。	一九二六年他建立了中共玉林地方组织的第一个支部，中共玉林县支部任支部书记。
1929年6月初朱锡昂不幸被捕。	一九二九年六月初朱锡昂不幸被捕。
1928年朱锡昂回到广西恢复和发展基层党组织领导广西的革命运动。	一九二八年朱锡昂回到广西恢复和发展基层党组织领导广西的革命运动。
中国人民银行今天发布2018年12月末广义货币增长8.1%，与上年同期持平。	中国人民银行今天发布二零一八年十二月末广义货币增长百分之八点一，与上年同期持平。
1929年6月8日朱锡昂被秘密枪杀，10年42岁。	一九二九年六月八日朱锡昂被秘密枪杀，十年四十二岁。
从结构看，2018年对实体经济发放的人民币贷款占同期社会融资规模的81.4%。	从结构看，二零一八年对实体经济发放的人民币贷款占同期社会融资规模的百分之八十一点四。
同比高19.6个百分点。	同比高十九点六个百分点。
14号英国首相特雷莎梅呼吁，议会下院通过脱欧协议草案。	十四号英国首相特雷莎梅呼吁，议会下院通过脱欧协议草案。
抓获犯罪嫌疑人36人，冻结涉案赃款273万元。	抓获犯罪嫌疑人三十六人，冻结涉案赃款两百七十三万元。
我们党要团结带领人民实现两个100年奋斗目标。	我们党要团结带领人民实现两个一百年奋斗目标。
和李家沟煤矿矿长胡某某等6名相关责任人刑事拘留，并冻结企业银行账户。	和李家沟煤矿矿长胡某某等六名相关责任人刑事拘留，并冻结企业银行账户。
2018年社会融资规模增量累计为19.26万亿元。	二零一八年社会融资规模增量累计为十九点二六万亿元。
近期一份民调结果显示，只有18%的英国人认可英国政府目前这份脱欧协议草案。	近期一份民调结果显示，只有百分之十八的英国人认可英国政府目前这份脱欧协议草案。
伊朗媒体14号援引伊朗军方的声明报道说。	伊朗媒体十四号援引伊朗军方的声明报道说。
当天在伊朗首都德黑兰附近机场失事的波音707货机的黑匣子已经找到。	当天在伊朗首都德黑兰附近机场失事的波音百零七货机的黑匣子已经找到。
机上16名机组成员全部是伊朗人。	机上十六名机组成员全部是伊朗人。
14号美国联邦政府部分机构停摆进入第24天。	十四号美国联邦政府部分机构停摆进入第二十四天。
国际奥委会委员迪亚克的儿子总计约280万新加坡元，约合人民币1399万元。	国际奥委会委员迪亚克的儿子总计约两百八十万新加坡元，约合人民币一千三百九十九万元。
法国司法部门11号证实已对此事展开调查。	法国司法部门十一号证实已对此事展开调查。
今天是2019年1月15号星期二，农历12月初十，欢迎收看新闻联播节目。	今天是二零一九年一月十五号星期二，农历十二月初十，欢迎收看新闻联播节目。
2014年1月习近平总书记在中央政法工作会议上强调。	二零一四年一月习近平总书记在中央政法工作会议上强调。
这是2018年岁末被中国国家博物馆永久收藏的一张年度照片。	这是二零一八年岁末被中国国家博物馆永久收藏的一张年度照片。
拍摄的时间是2018年5月31日。	拍摄的时间是二零一八年五月三十一日。
多年来，南京市一家企业先后将2600多吨工业废酸偷排到这里，造成严重污染。	多年来，南京市一家企业先后将二千六百多吨工业废酸偷排到这里，造成严重污染。
5年来司法机关刀刃向内，全力推进司法体制改革，建立起来维护公平正义的四梁八柱。	五年来司法机关刀刃向内，全力推进司法体制改革，建立起来维护公平正义的四梁八柱。
法院最终作出判决，对该公司处罚金2000万元，赔偿环境修复费用2428.29万元。	法院最终作出判决，对该公司处罚金两千万元，赔偿环境修复费用两千四百二十八点二九万元。
"99,441件，挽回直接经济损失239亿多元。"	九万九千四百四十一件，挽回直接经济损失两百三十九亿多元。
2017年5月19号。	二零一七年五月十九号。
习近平总书记在会见全国公安系统英雄模范立功集体时，对公安工作提出了16字总要求。	习近平总书记在会见全国公安系统英雄模范立功集体时，对公安工作提出了十六字总要求。
这16个字也成了新时代人民公安建警治警的总纲领。	这十六个字也成了新时代人民公安建警治警的总纲领。
2018年上海市建成的2700多个智能安防小区，实现了可防性案件全年零发案。	二零一八年上海市建成的两千七百多个智能安防小区，实现了可防性案件全年零发案。
国务院总理李克强15号在人民大会堂会见芬兰总统尼尼斯托。	国务院总理李克强十五号在人民大会堂会见芬兰总统尼尼斯托。
1月15号，全国人大常委会委员长栗战书在人民大会堂会见芬兰总统尼尼斯托。	一月十五号，全国人大常委会委员长栗战书在人民大会堂会见芬兰总统尼尼斯托。
芬兰愿助力中国成功举办2022年冬奥会。陈竺参加会见。	芬兰愿助力中国成功举办二零二二年冬奥会。陈竺参加会见。
将分别于2019年3月5号和3月3号在北京开幕。	将分别于二零一九年三月五号和三月三号在北京开幕。
十三届全国人大二次会议，全国政协十三届二次会议将在北京市复兴路乙11号梅地亚中心设立新闻中心。	十三届全国人大二次会议，全国政协十三届二次会议将在北京市复兴路乙十一号梅地亚中心设立新闻中心。
新闻中心将于2月27号正式开展工作。	新闻中心将于二月二十七号正式开展工作。
记者报名截止日期为2月25号。	记者报名截止日期为二月二十五号。
国家统计局的数据显示，2018年农村居民收入增长快于城镇居民。	国家统计局的数据显示，二零一八年农村居民收入增长快于城镇居民。
铁路预计发送旅客1050万人次。	铁路预计发送旅客一千零五十万人次。
今天是春运的第12天，热点地区迎来了春运大客流。	今天是春运的第十二天，热点地区迎来了春运大客流。
"民航已执行航班近18,000班，创下历史新高。"	民航已执行航班近十万八千班，创下历史新高。
沈阳铁路184组高寒动车组全部上线投入运用。	沈阳铁路一百八十四组高寒动车组全部上线投入运用。
给71集团军某旅王杰班全体战士回信。	给七十一集团军某旅王杰班全体战士回信。
三亚等10个大型机场24小时开放。	三亚等十个大型机场二十四小时开放。
今年1月以来，各地扫黄打非办公室会同公安、网信文化执法等部门开展春节前文化市场环境专项整治。	今年一月以来，各地扫黄打非办公室会同公安、网信文化执法等部门开展春节前文化市场环境专项整治。
春节期间，各界群众若发现涉黄涉非违法行为，可通过全国扫黄打非办公室举报电话12390。	春节期间，各界群众若发现涉黄涉非违法行为，可通过全国扫黄打非办公室举报电话一二三九零。
同时今年春晚还将首次进行4k超高清直播。	同时今年春晚还将首次进行四k超高清直播。
应国务院新闻办公室和中国驻埃及大使馆邀请1月25号到31号埃及媒体代表团在新疆进行采访。	应国务院新闻办公室和中国驻埃及大使馆邀请一月二十五号到三十一号埃及媒体代表团在新疆进行采访。
国家移民管理局今天发布2019春节假期客流预测。	国家移民管理局今天发布两千零一十九春节假期客流预测。
全国口岸出入境日军人数将达到177万人次，较去年同期增长8.9%。	全国口岸出入境日军人数将达到一百七十七万人次，较去年同期增长百分之八点九。
穿山甲鳞片170，11袋共重8268公斤。目前该案正在进一步调查中。	穿山甲鳞片一百七十，十一袋共重八二六八公斤。目前该案正在进一步调查中。
但明天夜间起新一股冷空气又将开始影响中东部地区，届时华北东北等地将出现4~8摄氏度的降温。	但明天夜间起新一股冷空气又将开始影响中东部地区，届时华北东北等地将出现四~八摄氏度的降温。
法国、德国和英国1月31号发表联合声明。	法国、德国和英国一月三十一号发表联合声明。
2015年7月，伊朗与伊核问题六国达成伊朗核问题全面协议。	二零一五年七月，伊朗与伊核问题六国达成伊朗核问题全面协议。
1月31号，美国中西部有30多个地区的气温创历史新低。	一月三十一号，美国中西部有三十多个地区的气温创历史新低。
明尼苏达州卡顿市的最低气温降到了零下48摄氏度。	明尼苏达州卡顿市的最低气温降到了零下四十八摄氏度。
当地时间1月31号晚间的温度也就在零下30摄氏度左右。	当地时间一月三十一号晚间的温度也就在零下三十摄氏度左右。
黎巴嫩新一届内阁1月31号组建完成。	黎巴嫩新一届内阁一月三十一号组建完成。
少年法老图坦卡蒙生活在公元前14世纪，9岁登基，19岁去世。	少年法老图坦卡蒙生活在公元前十四世纪，九岁登基，十九岁去世。
曾于2017年11月在沙特访问期间突然宣布辞职。	曾于二零一七年十一月在沙特访问期间突然宣布辞职。
今天是2019年2月1号。	今天是二零一九年二月一号。
报道称，进入销售渠道的疑似问题，牛肉总计近10吨。	报道称，进入销售渠道的疑似问题，牛肉总计近十吨。
习近平2019年1月21号。	习近平二零一九年一月二十一号。
星期五农历12月27，欢迎收看新闻联播节目。	星期五农历十二月二十七，欢迎收看新闻联播节目。
李克强在贺信中表示，60多年来包括48家集团俱乐部在内的英国友好人士。	李克强在贺信中表示，六十多年来包括四十八家集团俱乐部在内的英国友好人士。
中国政府高度赞赏48家集团俱乐部为增进中英友好所做努力。	中国政府高度赞赏四十八家集团俱乐部为增进中英友好所做努力。
对2019年工作提出殷切希望。	对二零一九年工作提出殷切希望。
要以新中国成立70周年为契机。	要以新中国成立七十周年为契机。
随着春节临近，客流增幅将在20%左右。	随着春节临近，客流增幅将在百分之二十左右。
李克强向中英贸易破冰之旅65周年纪念活动致贺信。	李克强向中英贸易破冰之旅六十五周年纪念活动致贺信。
习近平将出席告台湾同胞书，发表40周年纪念会，并发表重要讲话。	习近平将出席告台湾同胞书，发表四十周年纪念会，并发表重要讲话。
习近平主席新年贺词中指出，2019年有机遇也有挑战，大家还要一起拼搏，一起奋斗。	习近平主席新年贺词中指出，二零一九年有机遇也有挑战，大家还要一起拼搏，一起奋斗。
习近平主席2019年新年贺词，在全国广大干部群众全军和武警部队官兵中引起强烈反响。	习近平主席二零一九年新年贺词，在全国广大干部群众全军和武警部队官兵中引起强烈反响。
开山岛上新选出10位驻岛民兵坚守开山岛。	开山岛上新选出十位驻岛民兵坚守开山岛。
习近平在贺信中指出，中美建交40年来，两国关系历经风雨，取得了历史性发展。	习近平在贺信中指出，中美建交四十年来，两国关系历经风雨，取得了历史性发展。
他土木当地时间1月1号清晨，中国第二批赴苏丹达尔富尔维和直升机分队官兵。	他土木当地时间一月一号清晨，中国第二批赴苏丹达尔富尔维和直升机分队官兵。
本台消息，1月1号国家主席习近平与美国总统特朗普互致贺信，热烈祝贺两国建交40周年。	本台消息，一月一号国家主席习近平与美国总统特朗普互致贺信，热烈祝贺两国建交四十周年。
征集时间将持续至2019年6月30号，优秀作品将在中央主要新闻媒体刊发并结集出版。	征集时间将持续至二零一九年六月三十号，优秀作品将在中央主要新闻媒体刊发并结集出版。
98.5%的群众可在同一场所一次性完成全部办证手续。	百分之九十八点五的群众可在同一场所一次性完成全部办证手续。
内地居民可在全国范围内异地申请换补发出入境证件等5项新举措推出以来。	内地居民可在全国范围内异地申请换补发出入境证件等五项新举措推出以来。
累计有1536万名群众享受异地换补发出入境证件7个工作日内办结证件的便利。	累计有一千五百三十六万名群众享受异地换补发出入境证件七个工作日内办结证件的便利。
昨天我国自主设计建设的政府1100千伏昌吉股权特高压直流输电工程双极全压正式启动送电。	昨天我国自主设计建设的政府一千一百千伏昌吉股权特高压直流输电工程双极全压正式启动送电。
工程于2016年1月开工建设。起于新疆昌吉止于安徽股权，全长3293公里。	工程于二零一六年一月开工建设。起于新疆昌吉止于安徽股权，全长三千二百九十三公里。
额定电压±1100千伏，输电容量1200万千瓦。	额定电压正负一千一百千伏，输电容量一千两百万千瓦。
2018年全国电影总票房为609.76亿元，比上年的559.1亿元，增长9.06%。	二零一八年全国电影总票房为六百零九点七六亿元，比上年的五百五十九点一亿元，增长百分之九点零六。
其中国产电影票房为378.97亿元，占票房总额的62.15%。	其中国产电影票房为三百七十八点九七亿元，占票房总额的百分之六十二点一五。
俄罗斯联邦安全局网站2018年12月31号发布消息说。	俄罗斯联邦安全局网站二零一八年十二月三十一号发布消息说。
该机构于当年12月28号在莫斯科抓获一名美国籍间谍嫌疑人保罗惠兰。	该机构于当年十二月二十八号在莫斯科抓获一名美国籍间谍嫌疑人保罗惠兰。
2018年11月，阿富汗总统加尼呼吁塔利班放弃暴力手段，尽快加入阿富汗和平进程。	二零一八年十一月，阿富汗总统加尼呼吁塔利班放弃暴力手段，尽快加入阿富汗和平进程。
走过改革开放40周年的2018，来到新中国成立70周年的2019。	走过改革开放四十周年的二零一八，来到新中国成立七十周年的二零一九。
特朗普在贺信中说，2019年1月1号是美利坚合众国和中华人民共和国建立外交关系40周年纪念日。	特朗普在贺信中说，二零一九年一月一号是美利坚合众国和中华人民共和国建立外交关系四十周年纪念日。
本台消息，1月1号，中共中央总书记国家主席习近平就古巴革命胜利60周年。	本台消息，一月一号，中共中央总书记国家主席习近平就古巴革命胜利六十周年。
今天是2019年1月1号星期二农历11月26。	今天是二零一九年一月一号星期二农历十一月二十六。
60年来，在古巴共产党坚强领导下，古巴政府和人民艰苦奋斗，在社会主义建设事业中取得伟大成就。	六十年来，在古巴共产党坚强领导下，古巴政府和人民艰苦奋斗，在社会主义建设事业中取得伟大成就。
本台消息告台湾同胞书发表40周年纪念会，将于1月2号上午10:00在人民大会堂举行。	本台消息告台湾同胞书发表四十周年纪念会，将于一月二号上午十点在人民大会堂举行。
手机客户端有学习、视频学习两大板块，38个频道。	手机客户端有学习、视频学习两大板块，三十八个频道。
平台PC端有学习新思想、学习文化、环球视野等17个板块，180多个一级栏目。	平台PC端有学习新思想、学习文化、环球视野等十七个板块，一百八十多个一级栏目。
学习强国学习平台上线仪式1月1号在京举行。	学习强国学习平台上线仪式一月一号在京举行。
昨天国家主席习近平发表了2019年新年贺词。	昨天国家主席习近平发表了二零一九年新年贺词。
站在纪念改革开放40周年与迎接新中国华诞70周年的交汇点。	站在纪念改革开放四十周年与迎接新中国华诞七十周年的交汇点。
中美两国领导人互致贺信，庆祝两国建交40周年。	中美两国领导人互致贺信，庆祝两国建交四十周年。
在2019年新年贺词中，习主席叮嘱奋战在脱贫一线的同志们一定要保重身体。	在二零一九年新年贺词中，习主席叮嘱奋战在脱贫一线的同志们一定要保重身体。
习近平就古巴革命胜利60周年向古巴领导人致贺电。	习近平就古巴革命胜利六十周年向古巴领导人致贺电。
今天是4月1号星期一，农历2月26，欢迎收看新闻联播节目。	今天是四月一号星期一，农历二月二十六，欢迎收看新闻联播节目。
在会见香港澳门各界庆祝国家改革开放40周年访问团时发表的重要讲话精神。	在会见香港澳门各界庆祝国家改革开放四十周年访问团时发表的重要讲话精神。
蒙方认同人类命运共同体理念，愿同中方以建交70周年为契机，推动两国关系不断迈向更高水平。	蒙方认同人类命运共同体理念，愿同中方以建交七十周年为契机，推动两国关系不断迈向更高水平。
今天是第28个全国税收宣传月的首日，今年的主题是落实减税降费，促进经济高质量发展。	今天是第二十八个全国税收宣传月的首日，今年的主题是落实减税降费，促进经济高质量发展。
保持6%一档税率不变。	保持百分之六一档税率不变。
将适用16%税率的项目改按13%税率征税，将适用10%税率的项目改按9%税率征税。	将适用百分之十六税率的项目改按百分之十三税率征税，将适用百分之十税率的项目改按百分之九税率征税。
以去年的销售收入计算应该是在减免700万左右。	以去年的销售收入计算应该是在减免七百万左右。
据介绍，三部门已在4个月内完成了芬太尼类物质整类列管的法定程序。	据介绍，三部门已在四个月内完成了芬太尼类物质整类列管的法定程序。
卫星成功进入地球同步轨道。天恋2号01星是我国第二代数据中继卫星系统的第一颗卫星。	卫星成功进入地球同步轨道。天恋二号零一星是我国第二代数据中继卫星系统的第一颗卫星。
目前我国列管的芬太尼类物质品种达到25种，超过联合国规定管制的21种。	目前我国列管的芬太尼类物质品种达到二十五种，超过联合国规定管制的二十一种。
3月30号18时许，四川省凉山州木里县境内发生森林火灾，当地地形复杂，坡陡、谷深，交通通讯不便。	三月三十号十八时许，四川省凉山州木里县境内发生森林火灾，当地地形复杂，坡陡、谷深，交通通讯不便。
救治器官衰竭患者6.5万余名，我国每百万人口年捐献率已从2010年的0.03达到目前的4.53。	救治器官衰竭患者六点五万余名，我国每百万人口年捐献率已从二零一零年的零点零三达到目前的四点五三。
来自21个阿盟成员国的国家元首，政府首脑或代表出席此次为期一天的会议。	来自二十一个阿盟成员国的国家元首，政府首脑或代表出席此次为期一天的会议。
阿盟原本有22个成员国，2011年叙利亚危机爆发后，阿盟中止叙利亚的成员国资格。	阿盟原本有二十二个成员国，二零一一年叙利亚危机爆发后，阿盟中止叙利亚的成员国资格。
建交47年来，中兴关系一直走在中国同西方发达国家关系前列，创造了多项第一。	建交四十七年来，中兴关系一直走在中国同西方发达国家关系前列，创造了多项第一。
4月1号第6批在韩中国人民志愿军烈士遗骸及遗物在韩国仁川举行庄严仪式。	四月一号第六批在韩中国人民志愿军烈士遗骸及遗物在韩国仁川举行庄严仪式。
根据安排，4月3号这一批志愿军烈士遗骸将由中国空军专机接运回国。	根据安排，四月三号这一批志愿军烈士遗骸将由中国空军专机接运回国。
第30届阿拉伯国家联盟首脑会议3月31号在突尼斯举行，会议发表声明，坚决反对美国承认戈兰高地。	第三十届阿拉伯国家联盟首脑会议三月三十一号在突尼斯举行，会议发表声明，坚决反对美国承认戈兰高地。
根据俄罗斯外交部3月31号发布的最新消息。	根据俄罗斯外交部三月三十一号发布的最新消息。
这个项目建成后，将给当地提供1200个就业岗位。	这个项目建成后，将给当地提供一千两百个就业岗位。
3月31号举行的总统选举投票的计票已经过半。	三月三十一号举行的总统选举投票的计票已经过半。
3月23号，俄军两架军机运送了一批军人和35吨货物抵达委内瑞拉。	三月二十三号，俄军两架军机运送了一批军人和三十五吨货物抵达委内瑞拉。
要筑牢中心关系的社会基础，进一步加强两国教育、文化、科技等领域交流合作，办好2019中心旅游年。	要筑牢中心关系的社会基础，进一步加强两国教育、文化、科技等领域交流合作，办好二零一九中心旅游年。
5年多来，中国同各国秉持共商、共建、共享理念，探索合作思路，创新合作模式。	五年多来，中国同各国秉持共商、共建、共享理念，探索合作思路，创新合作模式。
70年来中国共产党领导中国人民持续奋斗，各方面都取得了巨大成就。	七十年来中国共产党领导中国人民持续奋斗，各方面都取得了巨大成就。
习近平强调，今年是中华人民共和国成立70周年，坚持中国共产党领导是中国人民的历史选择。	习近平强调，今年是中华人民共和国成立七十周年，坚持中国共产党领导是中国人民的历史选择。
同时我们坚持不断完善自己的发展道路，并正为实现两个100年奋斗目标而不懈努力。	同时我们坚持不断完善自己的发展道路，并正为实现两个一百年奋斗目标而不懈努力。
墨西哥前总统赛迪略表元老会代表团先后发言。他们首先祝贺中华人民共和国成立70周年。	墨西哥前总统赛迪略表元老会代表团先后发言。他们首先祝贺中华人民共和国成立七十周年。
杨洁篪、王毅等参加会见。元老会由南非前总统曼德拉倡议于2007年7月成立。	杨洁篪、王毅等参加会见。元老会由南非前总统曼德拉倡议于二零零七年七月成立。
本台消息，2019中国太平洋岛国旅游年4月1日在萨摩亚首都阿皮亚开幕。	本台消息，二零一九中国太平洋岛国旅游年四月一日在萨摩亚首都阿皮亚开幕。
习近平强调，举办2019中国太平洋岛国旅游年，是我和太平洋岛国领导人。	习近平强调，举办二零一九中国太平洋岛国旅游年，是我和太平洋岛国领导人。
哈利马表示祝贺。中华人民共和国成立70周年，中方倡议举办亚洲文明对话大会适逢其时。	哈利马表示祝贺。中华人民共和国成立七十周年，中方倡议举办亚洲文明对话大会适逢其时。
本台消息5月15号上午，亚洲文明对话大会将在北京国家会议中心隆重开幕。	本台消息五月十五号上午，亚洲文明对话大会将在北京国家会议中心隆重开幕。
5月13号，全国人大常委会委员长栗战书在人民大会堂会见希腊总统帕夫洛普洛斯。	五月十三号，全国人大常委会委员长栗战书在人民大会堂会见希腊总统帕夫洛普洛斯。
希腊总统帕夫洛普洛斯13号下午前往北京天安门广场，向人民英雄纪念碑敬献花圈。	希腊总统帕夫洛普洛斯十三号下午前往北京天安门广场，向人民英雄纪念碑敬献花圈。
另外还有100多位委员通过移动履职平台和参加分组讨论提出的意见建议。	另外还有一百多位委员通过移动履职平台和参加分组讨论提出的意见建议。
本次专题协商会有257位全国政协委员参加，79位院士委员分别做了大会发言和分组发言。	本次专题协商会有两百五十七位全国政协委员参加，七十九位院士委员分别做了大会发言和分组发言。
将于5月19号至24号对中国进行正式访问。	将于五月十九号至二十四号对中国进行正式访问。
并同王岐山副主席共同主持召开中国巴西高层协调与合作委员会第5次会议。	并同王岐山副主席共同主持召开中国巴西高层协调与合作委员会第五次会议。
由10%提高到25%。美方上述措施导致中美经贸摩擦升级。	由百分之十提高到百分之二十五。美方上述措施导致中美经贸摩擦升级。
经党中央国务院批准，国务院关税税则委员会决定，自2019年6月1号00:00起。	经党中央国务院批准，国务院关税税则委员会决定，自二零一九年六月一号零点起。
对已实施加征关税的600亿美元清单，美国商品中的部分，提高加征关税税率。	对已实施加征关税的六百亿美元清单，美国商品中的部分，提高加征关税税率。
国务院关税税则委员会13号发布公告，决定对原产于美国的部分进口商品提高加征关税税率。	国务院关税税则委员会十三号发布公告，决定对原产于美国的部分进口商品提高加征关税税率。
仍继续加征5%关税。	仍继续加征百分之五关税。
各位观众，今天的新闻联播节目大约需要37分钟，一下来看详细报道。	各位观众，今天的新闻联播节目大约需要三十七分钟，一下来看详细报道。
1亿多市场主体，中国经济拥有其他国家难以比拟的庞大市场。	一亿多市场主体，中国经济拥有其他国家难以比拟的庞大市场。
分别实施25%、20%或10%加征关税。对之前加征5%关税的税目商品。	分别实施百分之二十五、百分之二十或百分之十加征关税。对之前加征百分之五关税的税目商品。
从2018年3月美方单方面挑起摩擦到现在中方一直坚持通过对话解决分歧。	从二零一八年三月美方单方面挑起摩擦到现在中方一直坚持通过对话解决分歧。
3月份全国城镇调查失业率为5.2%，均低于预期控制目标。就业形势总体稳定的背后。	三月份全国城镇调查失业率为百分之五点二，均低于预期控制目标。就业形势总体稳定的背后。
是一系列实招硬招的强力支撑。就业大省广东年初就出台了促进就业9条政策。	是一系列实招硬招的强力支撑。就业大省广东年初就出台了促进就业九条政策。
今年一季度全国城镇新增就业324，万人同比基本持平。一季度末全国城镇登记失业率3.67%。	今年一季度全国城镇新增就业三百二十四，万人同比基本持平。一季度末全国城镇登记失业率百分之三点六七。
一季度我国服务业增加值占GDP比重持续上升到了57.3%，同比升高0.6个百分点。	一季度我国服务业增加值占GDP比重持续上升到了百分之五十七点三，同比升高零点六个百分点。
对不裁员或少裁员的参保企业，可返还其上年度实际缴纳失业保险费的50%。	对不裁员或少裁员的参保企业，可返还其上年度实际缴纳失业保险费的百分之五十。
特别提出要较大幅度减轻企业负担，通过降低社保费率，预计全年共为企业降低成本超过100亿以上。	特别提出要较大幅度减轻企业负担，通过降低社保费率，预计全年共为企业降低成本超过一百亿以上。
第三产业每100万元增加值吸纳的就业为8.1人，比第二产业高1.6人，经济吸纳就业的能力进一步增强。	第三产业每一百万元增加值吸纳的就业为八点一人，比第二产业高一点六人，经济吸纳就业的能力进一步增强。
一季度100个城市公共就业服务机构，市场求人倍率是1.28，同比环比均有所上升。	一季度一百个城市公共就业服务机构，市场求人倍率是一点二八，同比环比均有所上升。
亚洲文明对话大会新闻中心今天正式运营，境内外2900多名记者注册报道本次大会。	亚洲文明对话大会新闻中心今天正式运营，境内外两千九百多名记者注册报道本次大会。
有展将首次展出新中国成立以来发行的1300多套邮票。	有展将首次展出新中国成立以来发行的一千三百多套邮票。
自本月5号以来，美股仅标准普尔500指数的市值就已蒸发1.1万亿美元。	自本月五号以来，美股仅标准普尔五百指数的市值就已蒸发一点一万亿美元。
并威胁到近94万个就业机会。	并威胁到近九十四万个就业机会。
眼下这个数字已经超过260亿美元。	眼下这个数字已经超过两百六十亿美元。
在美国退出伊核协议，并不断加大对伊朗制裁后，伊朗总统鲁哈尼8号宣布终止履行伊核协议部分条款。	在美国退出伊核协议，并不断加大对伊朗制裁后，伊朗总统鲁哈尼八号宣布终止履行伊核协议部分条款。
今天是5月14号，星期二，农历4月初十，欢迎收看新闻联播节目。	今天是五月十四号，星期二，农历四月初十，欢迎收看新闻联播节目。
中华民族没有对外侵略的传统。600多年前郑和下西洋时率领的是当时世界最庞大的舰队。	中华民族没有对外侵略的传统。六百多年前郑和下西洋时率领的是当时世界最庞大的舰队。
中国今天所走的中国特色社会主义道路，是与5000年中华文明分不开的。	中国今天所走的中国特色社会主义道路，是与五千年中华文明分不开的。
我很高兴在中华人民共和国成立70周年之际来访，希腊人民钦佩中国发展取得的巨大成就。	我很高兴在中华人民共和国成立七十周年之际来访，希腊人民钦佩中国发展取得的巨大成就。
柬埔寨祝贺中华人民共和国成立70年来取得巨大发展成就，赞赏中国在国际事务中发挥的重要影响。	柬埔寨祝贺中华人民共和国成立七十年来取得巨大发展成就，赞赏中国在国际事务中发挥的重要影响。
会晤发表了金砖国家领导人第11次会晤巴西利亚宣言。	会晤发表了金砖国家领导人第十一次会晤巴西利亚宣言。
当地时间11月14号，金砖国家领导人同金砖国家工商理事会和新开发银行对话会在巴西利亚举行。	当地时间十一月十四号，金砖国家领导人同金砖国家工商理事会和新开发银行对话会在巴西利亚举行。
拉马福萨祝贺中华人民共和国成立70周年。	拉马福萨祝贺中华人民共和国成立七十周年。
李克强将同主要国际经济组织负责人举行第4次1+6圆桌对话会。	李克强将同主要国际经济组织负责人举行第四次一加六圆桌对话会。
本台消息。当地时间11月14号，国家主席习近平在巴西利亚出席金砖国家领导人第十一次会晤时。	本台消息。当地时间十一月十四号，国家主席习近平在巴西利亚出席金砖国家领导人第十一次会晤时。
本台消息明天出版的第22期求是杂志将发表。	本台消息明天出版的第二十二期求是杂志将发表。
在十九届中央政治局举行第5次集体学习时，就共产党宣言及其时代意义发表的重要讲话。	在十九届中央政治局举行第五次集体学习时，就共产党宣言及其时代意义发表的重要讲话。
国务院批复江苏响水天嘉仪化工有限公司321特别重大爆炸事故调查报告。	国务院批复江苏响水天嘉仪化工有限公司三百二十一特别重大爆炸事故调查报告。
多方人士表示，习近平主席在金砖国家领导人第11次会晤上的重要讲话，阐释了金砖国家的责任和担当。	多方人士表示，习近平主席在金砖国家领导人第十一次会晤上的重要讲话，阐释了金砖国家的责任和担当。
14号至15号，中共中央政治局常委国务院总理李克强在江西景德镇南昌考察。	十四号至十五号，中共中央政治局常委国务院总理李克强在江西景德镇南昌考察。
各位观众，今天的新闻联播节目大约需要56分钟，接下来请您收看详细内容。	各位观众，今天的新闻联播节目大约需要五十六分钟，接下来请您收看详细内容。
水库为1万多亩农田提供灌溉，目前蓄水量为50年代建库以来最低。	水库为一万多亩农田提供灌溉，目前蓄水量为五十年代建库以来最低。
7月以来江西发生了有记录以来最严重干旱，赣江出现历史最低水位。	七月以来江西发生了有记录以来最严重干旱，赣江出现历史最低水位。
和金融稳定理事会主席卡尔斯举行第4次圆桌对话会。	和金融稳定理事会主席卡尔斯举行第四次圆桌对话会。
中共中央政治局常委中央纪委书记赵乐际12号至15号到安徽调研。	中共中央政治局常委中央纪委书记赵乐际十二号至十五号到安徽调研。
部署自2019年12月1号起，在全国自贸试验区开展证照分离改革，全覆盖试点。	部署自二零一九年十二月一号起，在全国自贸试验区开展证照分离改革，全覆盖试点。
审批改为备案，实行告知承诺，优化审批服务等4种方式分类推进改革。	审批改为备案，实行告知承诺，优化审批服务等四种方式分类推进改革。
本台今天刊播央视快评携手打造第二个金色10年。	本台今天刊播央视快评携手打造第二个金色十年。
习近平主席14号在巴西就香港局势发表的重要讲话，发出了，中央政府对香港只报至乱工作的最强音。	习近平主席十四号在巴西就香港局势发表的重要讲话，发出了，中央政府对香港只报至乱工作的最强音。
这是中央政府在香港修历风波持续5个多月。	这是中央政府在香港修历风波持续五个多月。
在巴西出席金砖国家领导人第11次会晤时，就香港当前局势发表重要讲话，表明中国中央政府的严正立场。	在巴西出席金砖国家领导人第十一次会晤时，就香港当前局势发表重要讲话，表明中国中央政府的严正立场。
2011年朱友勇当选为中国工程院院士。2015年在澜沧县扶贫期间，它仍然立足于科技创新。	二零一一年朱友勇当选为中国工程院院士。二零一五年在澜沧县扶贫期间，它仍然立足于科技创新。
带领团队研发的零下37种植技术，让中药材种植归到深山老林。	带领团队研发的零下三十七种植技术，让中药材种植归到深山老林。
中国科学院成立于1949年11月1日70年来中国科学院以创新科技服务国家，造福人民为使命。	中国科学院成立于一九四九年十一月一日七十年来中国科学院以创新科技服务国家，造福人民为使命。
中央政府和全国14亿人民永远是香港战胜任何风险挑战的最坚强后盾。	中央政府和全国十四亿人民永远是香港战胜任何风险挑战的最坚强后盾。
今天北京下雨了，我现在是在360总部。	今天北京下雨了，我现在是在三六零总部。
人生30年，你说人能有几个30年？	人生三十年，你说人能有几个三十年？
"但是故宫因为书画太多了，我们光绘画53,000幅。"	但是故宫因为书画太多了，我们光绘画五万三千幅。
这个一个叫这是6米×11米。	这个一个叫这是六米乘十一米。
